NAME,B19051_001E,B19051_002E,B19051_003E,B19058_001E,B19058_002E,B19058_003E,B19001_001E,B19001_002E,B19001_003E,B19001_004E,B19001_005E,B19001_006E,B19001_007E,B19001_008E,B19001_009E,B19001_010E,B19001_011E,B19001_012E,B19001_013E,B19001_014E,B19001_015E,B19001_016E,B19001_017E,state,county,tract,block group,GEOID
"Block Group 1, Census Tract 24, Jackson County, Oregon",390,281,109,390,18,372,390,0,5,35,18,43,7,16,10,10,22,54,46,51,50,0,23,41,029,002400,1,410290024001
"Block Group 1, Census Tract 9508, Lincoln County, Oregon",667,437,230,667,98,569,667,61,35,0,23,35,25,14,14,17,51,73,103,22,120,35,39,41,041,950800,1,410419508001
"Block Group 2, Census Tract 9508, Lincoln County, Oregon",935,406,529,935,200,735,935,45,72,50,132,94,68,83,32,35,95,105,65,31,28,0,0,41,041,950800,2,410419508002
"Block Group 1, Census Tract 9514, Lincoln County, Oregon",670,511,159,670,159,511,670,24,18,76,10,0,13,7,16,64,72,131,41,73,57,23,45,41,041,951400,1,410419514001
"Block Group 2, Census Tract 9514, Lincoln County, Oregon",549,379,170,549,207,342,549,49,30,66,25,13,23,54,0,13,13,114,87,35,0,7,20,41,041,951400,2,410419514002
"Block Group 2, Census Tract 27, Jackson County, Oregon",644,420,224,644,65,579,644,0,0,28,41,16,11,27,0,0,32,125,106,99,71,51,37,41,029,002700,2,410290027002
"Block Group 3, Census Tract 27, Jackson County, Oregon",1401,694,707,1401,226,1175,1401,29,180,124,81,124,47,94,69,34,104,215,49,88,97,15,51,41,029,002700,3,410290027003
"Block Group 1, Census Tract 27, Jackson County, Oregon",418,345,73,418,55,363,418,61,0,0,15,0,93,0,14,28,86,17,12,30,15,47,0,41,029,002700,1,410290027001
"Block Group 4, Census Tract 27, Jackson County, Oregon",711,506,205,711,206,505,711,111,0,29,24,81,65,3,87,0,33,52,95,44,53,34,0,41,029,002700,4,410290027004
"Block Group 3, Census Tract 11, Jackson County, Oregon",427,322,105,427,54,373,427,30,0,0,0,55,48,16,18,17,12,60,158,0,0,0,13,41,029,001100,3,410290011003
"Block Group 2, Census Tract 11, Jackson County, Oregon",1137,939,198,1137,161,976,1137,31,0,14,75,56,39,65,65,47,125,68,205,0,202,101,44,41,029,001100,2,410290011002
"Block Group 1, Census Tract 11, Jackson County, Oregon",521,288,233,521,123,398,521,58,30,44,33,11,0,0,0,28,83,70,75,52,0,18,19,41,029,001100,1,410290011001
"Block Group 1, Census Tract 13.01, Jackson County, Oregon",515,442,73,515,135,380,515,0,0,56,8,9,27,42,0,37,64,117,93,0,0,42,20,41,029,001301,1,410290013011
"Block Group 3, Census Tract 13.01, Jackson County, Oregon",308,246,62,308,67,241,308,7,13,23,0,0,0,0,21,18,56,31,31,64,10,23,11,41,029,001301,3,410290013013
"Block Group 2, Census Tract 21, Jackson County, Oregon",444,272,172,444,73,371,444,56,36,23,8,27,31,27,0,24,26,44,15,13,61,7,46,41,029,002100,2,410290021002
"Block Group 3, Census Tract 21, Jackson County, Oregon",420,314,106,420,25,395,420,13,14,18,0,8,0,21,8,0,64,37,69,40,18,34,76,41,029,002100,3,410290021003
"Block Group 5, Census Tract 29, Jackson County, Oregon",609,327,282,609,99,510,609,39,23,64,41,76,9,25,64,6,57,101,29,30,21,0,24,41,029,002900,5,410290029005
"Block Group 1, Census Tract 29, Jackson County, Oregon",392,241,151,392,137,255,392,92,33,0,0,33,0,32,17,16,13,36,102,0,0,18,0,41,029,002900,1,410290029001
"Block Group 2, Census Tract 29, Jackson County, Oregon",711,546,165,711,42,669,711,17,14,33,0,0,0,32,18,19,98,152,47,79,49,32,121,41,029,002900,2,410290029002
"Block Group 6, Census Tract 29, Jackson County, Oregon",381,259,122,381,60,321,381,0,17,17,0,32,33,16,17,0,71,58,23,44,25,14,14,41,029,002900,6,410290029006
"Block Group 3, Census Tract 18, Jackson County, Oregon",1119,806,313,1119,140,979,1119,59,113,59,31,22,52,26,50,20,15,191,131,73,81,119,77,41,029,001800,3,410290018003
"Block Group 1, Census Tract 18, Jackson County, Oregon",722,541,181,722,61,661,722,10,51,15,16,0,27,111,8,15,98,110,123,43,37,0,58,41,029,001800,1,410290018001
"Block Group 2, Census Tract 18, Jackson County, Oregon",1153,690,463,1153,113,1040,1153,79,31,11,50,101,0,17,47,16,111,173,227,104,77,57,52,41,029,001800,2,410290018002
"Block Group 2, Census Tract 20, Jackson County, Oregon",505,371,134,505,52,453,505,49,22,29,29,20,47,22,38,10,43,31,55,24,32,23,31,41,029,002000,2,410290020002
"Block Group 1, Census Tract 28, Jackson County, Oregon",652,512,140,652,108,544,652,0,61,46,7,15,42,0,36,20,121,81,65,47,17,27,67,41,029,002800,1,410290028001
"Block Group 3, Census Tract 28, Jackson County, Oregon",266,164,102,266,0,266,266,0,0,30,21,0,10,0,20,10,54,20,51,11,14,0,25,41,029,002800,3,410290028003
"Block Group 1, Census Tract 8, Jackson County, Oregon",1536,1082,454,1536,359,1177,1536,165,69,161,77,61,85,60,63,19,233,128,155,78,43,49,90,41,029,000800,1,410290008001
"Block Group 1, Census Tract 7, Jackson County, Oregon",680,510,170,680,131,549,680,17,30,33,0,56,32,55,29,52,66,44,124,102,21,19,0,41,029,000700,1,410290007001
"Block Group 2, Census Tract 7, Jackson County, Oregon",1037,841,196,1037,118,919,1037,67,0,16,46,52,88,62,116,76,93,146,171,18,67,19,0,41,029,000700,2,410290007002
"Block Group 2, Census Tract 500.01, Douglas County, Oregon",765,433,332,765,167,598,765,19,0,35,34,8,42,61,47,148,91,67,116,47,40,10,0,41,019,050001,2,410190500012
"Block Group 1, Census Tract 500.01, Douglas County, Oregon",303,209,94,303,20,283,303,9,0,17,0,0,65,21,0,0,19,33,47,24,54,14,0,41,019,050001,1,410190500011
"Block Group 4, Census Tract 500.01, Douglas County, Oregon",309,205,104,309,35,274,309,11,17,0,8,26,24,0,36,10,20,18,36,31,64,8,0,41,019,050001,4,410190500014
"Block Group 1, Census Tract 1800, Douglas County, Oregon",454,330,124,454,27,427,454,65,0,41,5,0,9,36,5,9,59,78,69,41,22,7,8,41,019,180000,1,410191800001
"Block Group 4, Census Tract 1800, Douglas County, Oregon",237,207,30,237,102,135,237,9,12,0,21,36,28,24,0,0,0,23,26,0,58,0,0,41,019,180000,4,410191800004
"Block Group 1, Census Tract 9704, Klamath County, Oregon",554,321,233,554,75,479,554,21,23,26,40,40,44,26,31,31,56,55,40,25,54,29,13,41,035,970400,1,410359704001
"Block Group 2, Census Tract 9714, Klamath County, Oregon",413,349,64,413,85,328,413,25,34,0,61,33,14,25,13,12,71,24,45,17,39,0,0,41,035,971400,2,410359714002
"Block Group 3, Census Tract 9714, Klamath County, Oregon",230,193,37,230,12,218,230,0,0,20,0,14,0,24,13,0,0,0,92,21,46,0,0,41,035,971400,3,410359714003
"Block Group 4, Census Tract 9715, Klamath County, Oregon",375,255,120,375,111,264,375,0,38,56,44,10,42,10,62,0,37,66,10,0,0,0,0,41,035,971500,4,410359715004
"Block Group 1, Census Tract 9715, Klamath County, Oregon",269,143,126,269,127,142,269,53,16,11,18,0,42,33,7,13,24,14,0,10,9,19,0,41,035,971500,1,410359715001
"Block Group 5, Census Tract 9715, Klamath County, Oregon",560,364,196,560,236,324,560,54,34,14,82,42,16,29,17,18,112,66,66,10,0,0,0,41,035,971500,5,410359715005
"Block Group 2, Census Tract 9715, Klamath County, Oregon",352,261,91,352,89,263,352,67,24,47,19,39,0,15,29,0,10,33,40,20,0,9,0,41,035,971500,2,410359715002
"Block Group 3, Census Tract 9718, Klamath County, Oregon",371,229,142,371,270,101,371,80,62,54,0,23,47,39,0,31,11,14,10,0,0,0,0,41,035,971800,3,410359718003
"Block Group 1, Census Tract 9504, Lincoln County, Oregon",901,564,337,901,288,613,901,114,22,56,104,83,84,80,29,13,61,77,73,36,44,17,8,41,041,950400,1,410419504001
"Block Group 3, Census Tract 30.02, Jackson County, Oregon",688,434,254,688,33,655,688,33,12,0,11,26,24,11,31,15,117,110,153,94,23,0,28,41,029,003002,3,410290030023
"Block Group 1, Census Tract 9501, Lincoln County, Oregon",884,612,272,884,222,662,884,59,41,69,106,70,98,41,20,14,114,58,39,45,11,43,56,41,041,950100,1,410419501001
"Block Group 2, Census Tract 9501, Lincoln County, Oregon",456,283,173,456,100,356,456,31,9,27,19,38,31,49,33,39,52,35,53,32,8,0,0,41,041,950100,2,410419501002
"Block Group 1, Census Tract 9511, Lincoln County, Oregon",353,276,77,353,65,288,353,24,12,5,21,6,24,32,18,27,18,28,63,26,6,12,31,41,041,951100,1,410419511001
"Block Group 2, Census Tract 9511, Lincoln County, Oregon",466,278,188,466,116,350,466,41,56,30,48,32,8,26,19,21,11,23,41,12,42,19,37,41,041,951100,2,410419511002
"Block Group 1, Census Tract 9516, Lincoln County, Oregon",611,434,177,611,136,475,611,37,50,28,81,34,40,0,6,4,116,70,84,42,5,14,0,41,041,951600,1,410419516001
"Block Group 3, Census Tract 9516, Lincoln County, Oregon",404,221,183,404,62,342,404,52,4,33,19,12,16,4,42,41,27,31,29,23,48,23,0,41,041,951600,3,410419516003
"Block Group 2, Census Tract 9516, Lincoln County, Oregon",595,250,345,595,170,425,595,98,43,5,30,18,18,63,40,76,62,33,54,29,20,0,6,41,041,951600,2,410419516002
"Block Group 1, Census Tract 9509, Lincoln County, Oregon",326,259,67,326,89,237,326,12,11,32,0,0,0,31,11,0,27,61,89,13,13,0,26,41,041,950900,1,410419509001
"Block Group 3, Census Tract 9509, Lincoln County, Oregon",464,376,88,464,101,363,464,19,44,21,19,16,6,41,0,36,38,81,92,41,0,10,0,41,041,950900,3,410419509003
"Block Group 2, Census Tract 9509, Lincoln County, Oregon",301,262,39,301,51,250,301,0,8,11,20,31,0,0,21,0,35,113,21,29,0,12,0,41,041,950900,2,410419509002
"Block Group 4, Census Tract 9509, Lincoln County, Oregon",390,183,207,390,70,320,390,5,58,46,75,0,31,22,0,0,34,62,44,0,0,13,0,41,041,950900,4,410419509004
"Block Group 2, Census Tract 9512, Lincoln County, Oregon",389,259,130,389,42,347,389,0,0,0,28,35,24,5,48,0,8,31,88,53,16,27,26,41,041,951200,2,410419512002
"Block Group 1, Census Tract 28, Marion County, Oregon",520,426,94,520,24,496,520,13,10,10,10,17,17,0,0,25,13,88,60,56,20,64,117,41,047,002800,1,410470028001
"Block Group 2, Census Tract 28, Marion County, Oregon",1026,827,199,1026,148,878,1026,34,0,74,64,29,90,53,37,23,44,91,160,85,59,65,118,41,047,002800,2,410470028002
"Block Group 2, Census Tract 101, Marion County, Oregon",209,177,32,209,18,191,209,0,0,5,3,0,0,2,2,11,14,39,31,27,26,19,30,41,047,010100,2,410470101002
"Block Group 1, Census Tract 106, Marion County, Oregon",109,61,48,109,30,79,109,3,8,11,3,13,10,2,8,0,11,6,6,17,3,2,6,41,047,010600,1,410470106001
"Block Group 2, Census Tract 222.01, Clackamas County, Oregon",1582,845,737,1582,370,1212,1582,90,117,97,41,212,45,182,133,16,52,233,234,87,0,43,0,41,005,022201,2,410050222012
"Block Group 1, Census Tract 222.01, Clackamas County, Oregon",202,148,54,202,56,146,202,10,0,22,0,0,30,39,14,0,16,0,71,0,0,0,0,41,005,022201,1,410050222011
"Block Group 2, Census Tract 235, Clackamas County, Oregon",534,445,89,534,69,465,534,17,0,0,0,67,19,0,21,37,0,34,55,52,165,32,35,41,005,023500,2,410050235002
"Block Group 5, Census Tract 235, Clackamas County, Oregon",373,272,101,373,68,305,373,0,68,18,0,0,0,33,0,0,16,0,30,0,83,41,84,41,005,023500,5,410050235005
"Block Group 1, Census Tract 235, Clackamas County, Oregon",533,370,163,533,126,407,533,0,22,83,0,0,29,18,39,0,58,51,81,0,41,75,36,41,005,023500,1,410050235001
"Block Group 1, Census Tract 238, Clackamas County, Oregon",463,316,147,463,18,445,463,0,0,15,0,31,66,16,15,0,0,28,64,61,20,41,106,41,005,023800,1,410050238001
"Block Group 3, Census Tract 238, Clackamas County, Oregon",200,165,35,200,0,200,200,12,0,0,0,0,0,0,0,0,14,43,15,16,14,52,34,41,005,023800,3,410050238003
"Block Group 5, Census Tract 238, Clackamas County, Oregon",410,269,141,410,27,383,410,0,0,32,0,15,0,32,0,29,63,24,49,45,108,13,0,41,005,023800,5,410050238005
"Block Group 2, Census Tract 216.01, Clackamas County, Oregon",1307,1036,271,1307,359,948,1307,63,17,52,137,115,27,102,17,118,166,198,170,63,62,0,0,41,005,021601,2,410050216012
"Block Group 3, Census Tract 216.01, Clackamas County, Oregon",469,348,121,469,65,404,469,0,38,13,9,41,0,0,15,24,12,78,123,54,42,20,0,41,005,021601,3,410050216013
"Block Group 3, Census Tract 9701, Klamath County, Oregon",282,158,124,282,113,169,282,58,24,12,31,45,28,34,0,0,33,4,13,0,0,0,0,41,035,970100,3,410359701003
"Block Group 1, Census Tract 9701, Klamath County, Oregon",192,185,7,192,39,153,192,0,0,31,12,0,36,0,7,0,0,8,58,33,0,0,7,41,035,970100,1,410359701001
"Block Group 2, Census Tract 30.02, Jackson County, Oregon",625,433,192,625,126,499,625,14,13,75,13,25,0,64,0,16,88,64,65,57,69,62,0,41,029,003002,2,410290030022
"Block Group 1, Census Tract 25, Jackson County, Oregon",475,311,164,475,47,428,475,24,0,0,22,12,5,0,0,10,56,51,50,88,29,75,53,41,029,002500,1,410290025001
"Block Group 2, Census Tract 25, Jackson County, Oregon",306,197,109,306,37,269,306,9,28,5,18,17,18,14,1,18,28,15,38,29,41,4,23,41,029,002500,2,410290025002
"Block Group 2, Census Tract 9, Jackson County, Oregon",1059,769,290,1059,65,994,1059,50,16,28,42,67,27,75,0,31,107,133,185,88,69,14,127,41,029,000900,2,410290009002
"Block Group 1, Census Tract 9, Jackson County, Oregon",426,368,58,426,34,392,426,0,19,36,0,28,0,0,0,12,15,71,52,85,80,0,28,41,029,000900,1,410290009001
"Block Group 1, Census Tract 14, Jackson County, Oregon",1814,1111,703,1814,235,1579,1814,38,25,73,46,90,46,0,34,54,165,180,291,373,83,73,243,41,029,001400,1,410290014001
"Block Group 2, Census Tract 23, Jackson County, Oregon",388,259,129,388,37,351,388,28,0,11,23,8,20,15,21,8,21,24,106,30,12,32,29,41,029,002300,2,410290023002
"Block Group 1, Census Tract 2.01, Jackson County, Oregon",456,358,98,456,256,200,456,35,50,41,5,38,29,50,23,28,32,95,3,18,0,9,0,41,029,000201,1,410290002011
"Block Group 3, Census Tract 2.01, Jackson County, Oregon",542,476,66,542,154,388,542,123,56,52,55,22,104,28,19,0,36,13,8,26,0,0,0,41,029,000201,3,410290002013
"Block Group 1, Census Tract 15, Jackson County, Oregon",359,297,62,359,0,359,359,22,0,0,0,0,16,0,0,29,62,12,54,48,19,24,73,41,029,001500,1,410290015001
"Block Group 2, Census Tract 15, Jackson County, Oregon",822,539,283,822,50,772,822,0,52,73,67,14,36,25,0,50,0,42,174,58,82,27,122,41,029,001500,2,410290015002
"Block Group 2, Census Tract 24, Jackson County, Oregon",339,273,66,339,29,310,339,21,10,27,14,15,10,22,23,9,15,24,5,65,36,19,24,41,029,002400,2,410290024002
"Block Group 1, Census Tract 9505, Umatilla County, Oregon",656,510,146,656,103,553,656,73,14,79,35,10,25,37,28,4,82,68,79,68,0,45,9,41,059,950500,1,410599505001
"Block Group 2, Census Tract 9505, Umatilla County, Oregon",654,459,195,654,79,575,654,26,12,77,19,12,66,30,37,17,51,68,120,22,90,7,0,41,059,950500,2,410599505002
"Block Group 3, Census Tract 9505, Umatilla County, Oregon",154,103,51,154,15,139,154,8,0,36,4,2,4,9,0,2,11,16,18,14,0,14,16,41,059,950500,3,410599505003
"Block Group 2, Census Tract 9507, Umatilla County, Oregon",317,267,50,317,116,201,317,22,34,8,16,11,0,75,20,57,16,11,46,0,0,1,0,41,059,950700,2,410599507002
"Block Group 1, Census Tract 9507, Umatilla County, Oregon",408,364,44,408,86,322,408,18,19,14,34,0,9,30,79,2,21,36,87,0,8,51,0,41,059,950700,1,410599507001
"Block Group 3, Census Tract 9507, Umatilla County, Oregon",295,229,66,295,85,210,295,0,31,0,17,11,17,30,9,0,53,26,64,21,16,0,0,41,059,950700,3,410599507003
"Block Group 2, Census Tract 9509, Umatilla County, Oregon",365,313,52,365,64,301,365,0,33,0,40,0,63,0,7,7,63,32,18,65,10,18,9,41,059,950900,2,410599509002
"Block Group 3, Census Tract 9509, Umatilla County, Oregon",879,654,225,879,118,761,879,0,0,19,37,86,0,51,29,97,111,50,198,50,58,93,0,41,059,950900,3,410599509003
"Block Group 1, Census Tract 9509, Umatilla County, Oregon",494,389,105,494,317,177,494,113,0,85,10,159,0,13,0,10,47,30,0,27,0,0,0,41,059,950900,1,410599509001
"Block Group 1, Census Tract 9502, Umatilla County, Oregon",497,404,93,497,189,308,497,47,79,33,0,0,0,29,10,0,80,91,30,28,0,60,10,41,059,950200,1,410599502001
"Block Group 3, Census Tract 9502, Umatilla County, Oregon",436,415,21,436,40,396,436,34,53,0,0,6,31,0,8,0,39,83,138,11,0,33,0,41,059,950200,3,410599502003
"Block Group 5, Census Tract 9502, Umatilla County, Oregon",401,287,114,401,8,393,401,0,0,31,90,13,53,0,0,44,71,55,0,26,0,10,8,41,059,950200,5,410599502005
"Block Group 4, Census Tract 9502, Umatilla County, Oregon",357,226,131,357,227,130,357,64,51,12,0,28,47,0,0,0,46,53,7,49,0,0,0,41,059,950200,4,410599502004
"Block Group 2, Census Tract 9502, Umatilla County, Oregon",490,399,91,490,165,325,490,70,37,12,69,0,91,0,9,38,23,70,37,10,24,0,0,41,059,950200,2,410599502002
"Block Group 6, Census Tract 9502, Umatilla County, Oregon",206,77,129,206,21,185,206,20,21,0,0,32,13,0,0,30,0,66,24,0,0,0,0,41,059,950200,6,410599502006
"Block Group 1, Census Tract 9514, Umatilla County, Oregon",602,420,182,602,132,470,602,47,33,12,26,25,32,34,49,9,66,50,67,86,0,7,59,41,059,951400,1,410599514001
"Block Group 2, Census Tract 108.02, Marion County, Oregon",534,449,85,534,43,491,534,0,0,18,0,0,14,60,0,16,0,33,108,146,64,27,48,41,047,010802,2,410470108022
"Block Group 4, Census Tract 108.02, Marion County, Oregon",862,683,179,862,207,655,862,5,19,6,4,35,6,88,24,64,110,121,188,74,36,71,11,41,047,010802,4,410470108024
"Block Group 4, Census Tract 18.01, Marion County, Oregon",522,473,49,522,222,300,522,13,0,50,70,104,15,62,0,23,0,68,55,29,0,12,21,41,047,001801,4,410470018014
"Block Group 3, Census Tract 18.01, Marion County, Oregon",476,398,78,476,30,446,476,0,36,0,15,0,43,14,57,48,13,97,95,46,0,12,0,41,047,001801,3,410470018013
"Block Group 2, Census Tract 18.01, Marion County, Oregon",765,469,296,765,116,649,765,52,41,59,0,56,53,85,18,128,62,60,117,34,0,0,0,41,047,001801,2,410470018012
"Block Group 1, Census Tract 228, Clackamas County, Oregon",583,242,341,583,15,568,583,29,17,84,40,17,39,16,30,0,110,65,39,0,31,29,37,41,005,022800,1,410050228001
"Block Group 3, Census Tract 228, Clackamas County, Oregon",279,202,77,279,0,279,279,0,0,35,0,0,0,0,17,0,0,17,35,57,48,31,39,41,005,022800,3,410050228003
"Block Group 2, Census Tract 232.02, Clackamas County, Oregon",717,563,154,717,99,618,717,0,0,0,81,0,72,14,49,14,13,100,133,50,58,49,84,41,005,023202,2,410050232022
"Block Group 2, Census Tract 302.02, Yamhill County, Oregon",353,291,62,353,71,282,353,17,18,33,0,0,11,28,65,43,37,16,26,31,28,0,0,41,071,030202,2,410710302022
"Block Group 1, Census Tract 302.02, Yamhill County, Oregon",915,843,72,915,280,635,915,0,20,0,0,82,27,34,125,86,90,114,205,86,39,1,6,41,071,030202,1,410710302021
"Block Group 2, Census Tract 9503, Baker County, Oregon",511,290,221,511,171,340,511,59,52,11,47,57,36,14,15,31,34,73,13,40,7,5,17,41,001,950300,2,410019503002
"Block Group 3, Census Tract 9503, Baker County, Oregon",213,113,100,213,98,115,213,16,17,30,17,13,13,10,15,9,13,16,11,23,0,0,10,41,001,950300,3,410019503003
"Block Group 3, Census Tract 9501, Baker County, Oregon",518,321,197,518,62,456,518,45,16,15,0,37,26,25,0,44,29,82,76,41,0,51,31,41,001,950100,3,410019501003
"Block Group 1, Census Tract 9501, Baker County, Oregon",396,218,178,396,65,331,396,65,35,15,44,20,32,16,15,8,15,15,41,35,10,24,6,41,001,950100,1,410019501001
"Block Group 3, Census Tract 9504, Baker County, Oregon",302,252,50,302,58,244,302,0,0,27,13,68,8,31,45,8,23,12,8,19,40,0,0,41,001,950400,3,410019504003
"Block Group 1, Census Tract 9504, Baker County, Oregon",681,376,305,681,100,581,681,0,44,42,38,29,52,13,75,49,102,54,43,71,37,20,12,41,001,950400,1,410019504001
"Block Group 1, Census Tract 9506, Baker County, Oregon",248,138,110,248,7,241,248,8,3,0,30,12,16,20,25,30,0,18,47,0,32,0,7,41,001,950600,1,410019506001
"Block Group 3, Census Tract 9502, Baker County, Oregon",477,296,181,477,80,397,477,43,37,112,0,36,28,28,23,0,32,60,27,41,5,0,5,41,001,950200,3,410019502003
"Block Group 2, Census Tract 9505, Baker County, Oregon",254,139,115,254,62,192,254,16,0,11,0,26,13,9,86,11,82,0,0,0,0,0,0,41,001,950500,2,410019505002
"Block Group 1, Census Tract 9505, Baker County, Oregon",742,555,187,742,81,661,742,25,0,40,58,81,84,31,70,10,25,56,79,49,85,15,34,41,001,950500,1,410019505001
"Block Group 1, Census Tract 3611, Josephine County, Oregon",1001,436,565,1001,162,839,1001,128,55,123,27,0,35,28,91,0,150,130,90,62,46,24,12,41,033,361100,1,410333611001
"Block Group 3, Census Tract 3611, Josephine County, Oregon",884,499,385,884,210,674,884,17,41,43,136,121,11,26,41,31,52,176,128,0,0,32,29,41,033,361100,3,410333611003
"Block Group 4, Census Tract 3613, Josephine County, Oregon",819,520,299,819,222,597,819,47,66,55,36,34,17,73,15,39,84,45,186,56,16,28,22,41,033,361300,4,410333613004
"Block Group 2, Census Tract 16.04, Marion County, Oregon",523,378,145,523,172,351,523,62,0,65,22,42,125,19,0,21,0,104,63,0,0,0,0,41,047,001604,2,410470016042
"Block Group 2, Census Tract 214, Clackamas County, Oregon",395,350,45,395,109,286,395,22,0,26,0,28,0,0,31,52,93,71,27,18,21,0,6,41,005,021400,2,410050214002
"Block Group 3, Census Tract 214, Clackamas County, Oregon",400,367,33,400,30,370,400,53,0,19,29,0,51,11,48,15,61,39,0,30,44,0,0,41,005,021400,3,410050214003
"Block Group 1, Census Tract 9718, Klamath County, Oregon",382,258,124,382,143,239,382,31,72,28,16,7,26,5,46,19,17,30,23,30,22,0,10,41,035,971800,1,410359718001
"Block Group 2, Census Tract 9703, Klamath County, Oregon",212,123,89,212,15,197,212,9,8,0,0,17,17,15,12,9,19,12,79,15,0,0,0,41,035,970300,2,410359703002
"Block Group 1, Census Tract 9703, Klamath County, Oregon",295,69,226,295,63,232,295,27,10,29,40,0,9,11,23,34,12,45,20,0,11,24,0,41,035,970300,1,410359703001
"Block Group 3, Census Tract 9703, Klamath County, Oregon",403,247,156,403,49,354,403,33,8,0,0,23,0,10,50,14,15,86,97,32,0,5,30,41,035,970300,3,410359703003
"Block Group 4, Census Tract 9703, Klamath County, Oregon",306,230,76,306,10,296,306,0,0,0,32,0,33,0,0,13,120,32,33,33,0,0,10,41,035,970300,4,410359703004
"Block Group 2, Census Tract 9705, Klamath County, Oregon",247,134,113,247,46,201,247,34,5,9,25,25,0,16,12,15,21,45,4,13,14,5,4,41,035,970500,2,410359705002
"Block Group 1, Census Tract 9705, Klamath County, Oregon",426,280,146,426,98,328,426,21,40,24,22,63,36,29,8,5,5,70,68,9,17,5,4,41,035,970500,1,410359705001
"Block Group 3, Census Tract 9711, Klamath County, Oregon",553,402,151,553,19,534,553,13,88,19,0,16,15,0,0,0,104,77,106,25,77,13,0,41,035,971100,3,410359711003
"Block Group 4, Census Tract 9711, Klamath County, Oregon",227,200,27,227,50,177,227,0,0,0,57,0,0,8,0,0,12,48,37,53,12,0,0,41,035,971100,4,410359711004
"Block Group 1, Census Tract 9711, Klamath County, Oregon",311,260,51,311,40,271,311,0,15,40,9,27,0,12,16,20,28,134,10,0,0,0,0,41,035,971100,1,410359711001
"Block Group 2, Census Tract 9711, Klamath County, Oregon",1049,779,270,1049,144,905,1049,0,20,0,14,27,0,85,0,48,212,67,226,118,39,130,63,41,035,971100,2,410359711002
"Block Group 2, Census Tract 106, Marion County, Oregon",627,483,144,627,88,539,627,28,17,23,31,26,30,55,8,63,57,47,70,68,66,11,27,41,047,010600,2,410470106002
"Block Group 3, Census Tract 106, Marion County, Oregon",291,146,145,291,62,229,291,24,26,16,6,14,11,9,19,28,14,28,68,4,15,6,3,41,047,010600,3,410470106003
"Block Group 3, Census Tract 13, Marion County, Oregon",289,230,59,289,9,280,289,0,0,0,0,0,0,31,18,8,34,28,83,31,25,31,0,41,047,001300,3,410470013003
"Block Group 1, Census Tract 13, Marion County, Oregon",825,723,102,825,50,775,825,15,0,61,8,26,17,32,7,16,33,103,131,128,44,83,121,41,047,001300,1,410470013001
"Block Group 3, Census Tract 15.01, Marion County, Oregon",726,459,267,726,161,565,726,9,38,9,66,42,42,64,9,73,40,138,91,46,13,9,37,41,047,001501,3,410470015013
"Block Group 1, Census Tract 15.01, Marion County, Oregon",473,387,86,473,64,409,473,0,9,26,9,33,35,10,0,14,17,80,86,46,31,35,42,41,047,001501,1,410470015011
"Block Group 4, Census Tract 16.02, Marion County, Oregon",651,557,94,651,46,605,651,0,28,0,184,0,19,0,0,90,0,117,145,33,35,0,0,41,047,001602,4,410470016024
"Block Group 2, Census Tract 16.02, Marion County, Oregon",941,706,235,941,419,522,941,105,33,62,68,222,49,107,114,88,17,63,13,0,0,0,0,41,047,001602,2,410470016022
"Block Group 1, Census Tract 16.02, Marion County, Oregon",806,676,130,806,352,454,806,19,68,53,44,74,50,57,27,42,173,124,27,0,0,0,48,41,047,001602,1,410470016021
"Block Group 3, Census Tract 18.02, Marion County, Oregon",381,381,0,381,99,282,381,0,0,0,0,0,17,0,0,14,123,60,83,36,21,27,0,41,047,001802,3,410470018023
"Block Group 2, Census Tract 18.02, Marion County, Oregon",462,371,91,462,72,390,462,0,25,15,0,0,31,18,0,68,14,188,0,48,0,55,0,41,047,001802,2,410470018022
"Block Group 1, Census Tract 23.01, Marion County, Oregon",948,762,186,948,136,812,948,0,0,10,7,18,104,35,30,16,83,243,115,139,69,35,44,41,047,002301,1,410470023011
"Block Group 1, Census Tract 107.02, Marion County, Oregon",418,263,155,418,14,404,418,0,0,0,0,0,107,15,16,33,27,46,33,33,41,0,67,41,047,010702,1,410470107021
"Block Group 2, Census Tract 107.02, Marion County, Oregon",933,801,132,933,198,735,933,32,51,0,87,16,64,29,145,12,58,48,98,92,43,95,63,41,047,010702,2,410470107022
"Block Group 4, Census Tract 108.01, Marion County, Oregon",230,168,62,230,16,214,230,0,15,0,62,0,15,18,0,0,26,13,34,0,14,17,16,41,047,010801,4,410470108014
"Block Group 5, Census Tract 108.01, Marion County, Oregon",639,492,147,639,130,509,639,76,0,6,32,65,15,78,17,11,33,71,59,25,19,65,67,41,047,010801,5,410470108015
"Block Group 1, Census Tract 108.01, Marion County, Oregon",433,417,16,433,104,329,433,12,0,0,43,0,15,38,3,36,13,190,14,30,39,0,0,41,047,010801,1,410470108011
"Block Group 2, Census Tract 108.01, Marion County, Oregon",345,274,71,345,7,338,345,15,16,0,15,29,48,0,0,0,53,0,74,53,42,0,0,41,047,010801,2,410470108012
"Block Group 2, Census Tract 232.01, Clackamas County, Oregon",746,558,188,746,77,669,746,41,16,17,0,41,18,27,16,24,45,39,75,60,127,48,152,41,005,023201,2,410050232012
"Block Group 1, Census Tract 232.01, Clackamas County, Oregon",740,534,206,740,33,707,740,16,8,51,16,0,0,49,32,9,41,42,113,86,103,128,46,41,005,023201,1,410050232011
"Block Group 1, Census Tract 236, Clackamas County, Oregon",408,291,117,408,21,387,408,0,0,0,20,17,0,10,11,0,31,41,56,36,103,73,10,41,005,023600,1,410050236001
"Block Group 3, Census Tract 243.02, Clackamas County, Oregon",761,527,234,761,129,632,761,104,17,11,18,20,60,34,35,19,32,11,228,57,37,45,33,41,005,024302,3,410050243023
"Block Group 2, Census Tract 203.04, Clackamas County, Oregon",574,459,115,574,12,562,574,28,16,0,15,29,0,0,15,31,31,14,142,57,28,84,84,41,005,020304,2,410050203042
"Block Group 1, Census Tract 203.04, Clackamas County, Oregon",711,656,55,711,57,654,711,0,0,0,13,51,0,0,15,15,20,87,34,36,117,109,214,41,005,020304,1,410050203041
"Block Group 1, Census Tract 212, Clackamas County, Oregon",933,395,538,933,127,806,933,115,0,17,100,61,18,67,64,24,99,94,106,62,53,27,26,41,005,021200,1,410050212001
"Block Group 1, Census Tract 224, Clackamas County, Oregon",399,280,119,399,38,361,399,47,32,17,23,0,7,26,14,16,24,41,75,23,9,34,11,41,005,022400,1,410050224001
"Block Group 1, Census Tract 9707, Klamath County, Oregon",281,153,128,281,9,272,281,7,0,5,0,65,12,4,47,0,44,15,41,10,16,7,8,41,035,970700,1,410359707001
"Block Group 2, Census Tract 9707, Klamath County, Oregon",590,487,103,590,58,532,590,23,27,12,21,3,26,47,46,95,35,79,86,41,9,32,8,41,035,970700,2,410359707002
"Block Group 3, Census Tract 9717, Klamath County, Oregon",220,149,71,220,114,106,220,22,41,34,20,26,20,0,12,9,28,7,1,0,0,0,0,41,035,971700,3,410359717003
"Block Group 2, Census Tract 9717, Klamath County, Oregon",459,323,136,459,90,369,459,56,8,73,7,0,21,18,0,41,18,37,117,18,22,7,16,41,035,971700,2,410359717002
"Block Group 1, Census Tract 9710, Klamath County, Oregon",317,218,99,317,61,256,317,17,34,37,0,14,59,39,0,0,6,9,14,47,0,17,24,41,035,971000,1,410359710001
"Block Group 1, Census Tract 9506, Umatilla County, Oregon",214,200,14,214,12,202,214,0,0,0,0,15,0,0,0,12,43,79,65,0,0,0,0,41,059,950600,1,410599506001
"Block Group 3, Census Tract 9506, Umatilla County, Oregon",236,140,96,236,110,126,236,94,32,0,0,0,27,31,52,0,0,0,0,0,0,0,0,41,059,950600,3,410599506003
"Block Group 6, Census Tract 9506, Umatilla County, Oregon",498,340,158,498,165,333,498,0,62,19,19,12,0,0,0,0,0,113,103,109,34,27,0,41,059,950600,6,410599506006
"Block Group 4, Census Tract 9508, Umatilla County, Oregon",1058,934,124,1058,68,990,1058,0,34,16,16,155,17,58,45,48,21,169,107,131,57,76,108,41,059,950800,4,410599508004
"Block Group 2, Census Tract 9508, Umatilla County, Oregon",325,294,31,325,106,219,325,63,84,53,41,0,0,0,17,0,16,24,12,0,0,0,15,41,059,950800,2,410599508002
"Block Group 1, Census Tract 9508, Umatilla County, Oregon",381,287,94,381,45,336,381,18,16,0,0,0,0,0,135,0,60,62,41,0,0,33,16,41,059,950800,1,410599508001
"Block Group 3, Census Tract 9508, Umatilla County, Oregon",266,174,92,266,122,144,266,38,78,0,0,26,0,14,0,0,28,0,82,0,0,0,0,41,059,950800,3,410599508003
"Block Group 1, Census Tract 9510, Umatilla County, Oregon",314,155,159,314,0,314,314,62,25,0,0,0,14,24,0,0,0,29,32,52,0,62,14,41,059,951000,1,410599510001
"Block Group 2, Census Tract 9510, Umatilla County, Oregon",871,605,266,871,340,531,871,154,102,0,75,83,0,0,10,32,15,106,107,30,50,86,21,41,059,951000,2,410599510002
"Block Group 4, Census Tract 9510, Umatilla County, Oregon",312,209,103,312,87,225,312,41,17,12,0,34,0,11,12,35,10,83,57,0,0,0,0,41,059,951000,4,410599510004
"Block Group 3, Census Tract 9510, Umatilla County, Oregon",505,348,157,505,74,431,505,47,10,30,0,50,0,59,6,0,64,39,146,47,0,0,7,41,059,951000,3,410599510003
"Block Group 3, Census Tract 2.03, Jackson County, Oregon",561,447,114,561,226,335,561,97,60,13,31,7,76,18,13,67,71,74,30,4,0,0,0,41,029,000203,3,410290002033
"Block Group 2, Census Tract 2.03, Jackson County, Oregon",637,555,82,637,161,476,637,18,17,28,39,12,28,28,72,13,81,95,65,40,56,45,0,41,029,000203,2,410290002032
"Block Group 1, Census Tract 2.03, Jackson County, Oregon",411,330,81,411,163,248,411,7,66,19,36,41,36,25,0,45,26,11,72,13,7,7,0,41,029,000203,1,410290002031
"Block Group 3, Census Tract 13.02, Jackson County, Oregon",1028,882,146,1028,344,684,1028,18,36,0,145,125,94,38,33,0,53,235,138,60,38,15,0,41,029,001302,3,410290013023
"Block Group 5, Census Tract 13.02, Jackson County, Oregon",413,292,121,413,32,381,413,25,0,0,67,0,16,54,35,14,0,40,119,43,0,0,0,41,029,001302,5,410290013025
"Block Group 1, Census Tract 13.02, Jackson County, Oregon",424,250,174,424,124,300,424,24,17,68,0,0,18,21,0,33,34,52,71,0,44,24,18,41,029,001302,1,410290013021
"Block Group 4, Census Tract 22, Jackson County, Oregon",698,454,244,698,75,623,698,39,77,0,80,0,75,0,33,49,30,126,33,15,47,33,61,41,029,002200,4,410290022004
"Block Group 2, Census Tract 22, Jackson County, Oregon",634,476,158,634,195,439,634,86,16,31,0,23,55,0,0,0,47,11,102,28,113,75,47,41,029,002200,2,410290022002
"Block Group 3, Census Tract 22, Jackson County, Oregon",556,374,182,556,38,518,556,18,13,14,0,34,0,38,15,16,19,17,109,67,17,64,115,41,029,002200,3,410290022003
"Block Group 1, Census Tract 30.01, Jackson County, Oregon",398,210,188,398,18,380,398,57,7,10,27,24,0,0,22,9,20,75,58,12,50,16,11,41,029,003001,1,410290030011
"Block Group 3, Census Tract 6.01, Jackson County, Oregon",803,570,233,803,63,740,803,0,17,30,29,13,80,17,65,0,139,59,86,88,0,117,63,41,029,000601,3,410290006013
"Block Group 1, Census Tract 6.01, Jackson County, Oregon",781,575,206,781,16,765,781,33,27,0,14,0,0,0,0,0,21,38,161,83,34,182,188,41,029,000601,1,410290006011
"Block Group 2, Census Tract 12, Jackson County, Oregon",55,47,8,55,11,44,55,8,0,0,0,0,0,0,0,11,0,0,0,7,29,0,0,41,029,001200,2,410290012002
"Block Group 1, Census Tract 12, Jackson County, Oregon",1479,1176,303,1479,217,1262,1479,74,11,59,52,50,104,77,79,208,210,169,149,112,46,55,24,41,029,001200,1,410290012001
"Block Group 2, Census Tract 240, Clackamas County, Oregon",268,210,58,268,30,238,268,10,0,20,0,12,10,0,32,0,9,75,18,26,27,29,0,41,005,024000,2,410050240002
"Block Group 2, Census Tract 218.02, Clackamas County, Oregon",1040,761,279,1040,281,759,1040,116,67,49,28,47,28,39,40,39,216,86,88,80,40,30,47,41,005,021802,2,410050218022
"Block Group 5, Census Tract 9510, Umatilla County, Oregon",291,240,51,291,159,132,291,0,0,45,0,38,28,51,13,54,10,11,0,17,0,24,0,41,059,951000,5,410599510005
"Block Group 2, Census Tract 9513, Umatilla County, Oregon",505,412,93,505,87,418,505,25,10,12,7,3,25,18,71,7,59,71,130,39,21,3,4,41,059,951300,2,410599513002
"Block Group 4, Census Tract 9513, Umatilla County, Oregon",431,375,56,431,126,305,431,0,11,25,23,57,9,14,15,24,91,41,49,53,15,4,0,41,059,951300,4,410599513004
"Block Group 1, Census Tract 9513, Umatilla County, Oregon",176,160,16,176,4,172,176,0,0,11,4,5,0,0,0,21,44,11,15,25,9,7,24,41,059,951300,1,410599513001
"Block Group 1, Census Tract 9501, Umatilla County, Oregon",743,576,167,743,250,493,743,17,38,9,82,33,97,10,20,30,85,104,105,74,6,23,10,41,059,950100,1,410599501001
"Block Group 3, Census Tract 9511, Umatilla County, Oregon",294,178,116,294,170,124,294,45,21,0,95,0,16,12,14,14,0,44,14,0,19,0,0,41,059,951100,3,410599511003
"Block Group 4, Census Tract 9511, Umatilla County, Oregon",185,153,32,185,20,165,185,20,12,0,0,0,15,0,0,0,50,40,38,0,10,0,0,41,059,951100,4,410599511004
"Block Group 5, Census Tract 9511, Umatilla County, Oregon",591,483,108,591,105,486,591,0,0,41,0,0,14,73,43,21,61,66,151,63,34,24,0,41,059,951100,5,410599511005
"Block Group 5, Census Tract 9512, Umatilla County, Oregon",587,545,42,587,53,534,587,0,0,11,0,35,11,0,0,10,21,26,166,106,151,32,18,41,059,951200,5,410599512005
"Block Group 2, Census Tract 9512, Umatilla County, Oregon",536,428,108,536,131,405,536,0,9,77,55,68,97,13,19,20,38,21,86,0,0,0,33,41,059,951200,2,410599512002
"Block Group 3, Census Tract 9512, Umatilla County, Oregon",254,242,12,254,14,240,254,0,0,45,21,0,13,31,19,0,47,53,25,0,0,0,0,41,059,951200,3,410599512003
"Block Group 6, Census Tract 9512, Umatilla County, Oregon",560,485,75,560,89,471,560,82,13,0,48,13,0,97,0,0,53,72,85,60,37,0,0,41,059,951200,6,410599512006
"Block Group 1, Census Tract 9518, Lincoln County, Oregon",355,134,221,355,88,267,355,35,0,20,70,34,19,43,0,0,21,26,46,19,7,7,8,41,041,951800,1,410419518001
"Block Group 2, Census Tract 9518, Lincoln County, Oregon",664,431,233,664,132,532,664,54,34,10,39,37,17,14,68,50,78,41,83,51,8,53,27,41,041,951800,2,410419518002
"Block Group 1, Census Tract 9517, Lincoln County, Oregon",872,428,444,872,142,730,872,58,41,94,50,43,46,25,20,35,150,80,121,81,0,11,17,41,041,951700,1,410419517001
"Block Group 1, Census Tract 204, Polk County, Oregon",549,411,138,549,156,393,549,38,17,18,27,36,29,46,12,29,55,39,78,68,4,48,5,41,053,020400,1,410530204001
"Block Group 4, Census Tract 204, Polk County, Oregon",666,484,182,666,192,474,666,46,55,19,29,32,23,14,35,45,75,39,105,86,22,30,11,41,053,020400,4,410530204004
"Block Group 2, Census Tract 204, Polk County, Oregon",640,449,191,640,135,505,640,36,23,34,21,19,23,52,26,99,29,40,81,62,65,30,0,41,053,020400,2,410530204002
"Block Group 5, Census Tract 204, Polk County, Oregon",240,220,20,240,0,240,240,0,20,35,0,0,0,17,0,0,0,14,23,51,19,61,0,41,053,020400,5,410530204005
"Block Group 2, Census Tract 201, Clackamas County, Oregon",369,271,98,369,20,349,369,0,8,0,19,7,0,0,8,8,46,0,62,52,37,34,88,41,005,020100,2,410050201002
"Block Group 1, Census Tract 201, Clackamas County, Oregon",922,690,232,922,0,922,922,27,0,0,0,30,26,12,0,15,47,80,83,89,69,118,326,41,005,020100,1,410050201001
"Block Group 1, Census Tract 203.02, Clackamas County, Oregon",536,445,91,536,45,491,536,0,19,0,36,23,29,0,32,4,39,50,67,51,47,36,103,41,005,020302,1,410050203021
"Block Group 2, Census Tract 203.02, Clackamas County, Oregon",1177,995,182,1177,76,1101,1177,39,35,9,21,8,0,0,44,18,51,171,210,137,114,116,204,41,005,020302,2,410050203022
"Block Group 1, Census Tract 3, Jackson County, Oregon",1227,1021,206,1227,405,822,1227,69,75,30,103,46,52,17,161,107,133,132,96,135,8,14,49,41,029,000300,1,410290003001
"Block Group 2, Census Tract 3, Jackson County, Oregon",1306,877,429,1306,587,719,1306,198,106,145,70,93,31,44,79,110,162,58,117,79,0,0,14,41,029,000300,2,410290003002
"Block Group 2, Census Tract 2.02, Jackson County, Oregon",457,415,42,457,161,296,457,42,30,45,9,7,25,0,0,69,61,113,14,0,16,16,10,41,029,000202,2,410290002022
"Block Group 3, Census Tract 2.02, Jackson County, Oregon",445,358,87,445,214,231,445,83,23,14,29,41,46,9,70,0,50,8,25,0,47,0,0,41,029,000202,3,410290002023
"Block Group 1, Census Tract 2.02, Jackson County, Oregon",531,373,158,531,158,373,531,35,31,67,57,6,8,31,31,9,71,46,47,7,72,9,4,41,029,000202,1,410290002021
"Block Group 2, Census Tract 17, Jackson County, Oregon",1077,976,101,1077,202,875,1077,239,0,15,78,136,45,45,64,50,16,137,89,52,68,16,27,41,029,001700,2,410290017002
"Block Group 3, Census Tract 17, Jackson County, Oregon",413,216,197,413,95,318,413,0,0,62,25,101,18,0,17,17,16,42,12,36,51,0,16,41,029,001700,3,410290017003
"Block Group 2, Census Tract 19, Jackson County, Oregon",290,205,85,290,111,179,290,25,26,14,11,13,14,30,3,7,21,36,11,7,4,36,32,41,029,001900,2,410290019002
"Block Group 1, Census Tract 1, Jackson County, Oregon",407,332,75,407,204,203,407,24,22,88,24,59,58,35,11,8,18,39,14,7,0,0,0,41,029,000100,1,410290001001
"Block Group 4, Census Tract 224, Clackamas County, Oregon",225,178,47,225,51,174,225,11,31,9,0,20,6,0,0,0,27,33,30,11,18,23,6,41,005,022400,4,410050224004
"Block Group 5, Census Tract 224, Clackamas County, Oregon",410,294,116,410,54,356,410,73,54,8,0,0,9,8,32,11,15,99,61,22,10,0,8,41,005,022400,5,410050224005
"Block Group 2, Census Tract 237, Clackamas County, Oregon",256,178,78,256,69,187,256,37,32,0,9,9,0,0,39,9,0,7,25,10,0,70,9,41,005,023700,2,410050237002
"Block Group 1, Census Tract 237, Clackamas County, Oregon",546,427,119,546,28,518,546,22,10,18,0,35,20,19,17,0,9,68,99,54,61,63,51,41,005,023700,1,410050237001
"Block Group 4, Census Tract 800, Douglas County, Oregon",467,305,162,467,34,433,467,18,14,0,0,33,17,31,0,48,35,31,148,16,76,0,0,41,019,080000,4,410190800004
"Block Group 5, Census Tract 800, Douglas County, Oregon",364,218,146,364,70,294,364,0,35,111,0,17,36,17,0,0,31,46,20,23,0,11,17,41,019,080000,5,410190800005
"Block Group 3, Census Tract 209, Clackamas County, Oregon",848,590,258,848,231,617,848,82,144,30,79,43,27,7,12,0,96,82,69,67,34,33,43,41,005,020900,3,410050209003
"Block Group 2, Census Tract 209, Clackamas County, Oregon",442,333,109,442,65,377,442,35,30,10,10,9,0,0,10,0,73,133,58,43,0,12,19,41,005,020900,2,410050209002
"Block Group 3, Census Tract 216.02, Clackamas County, Oregon",931,748,183,931,128,803,931,0,14,0,75,15,69,32,47,36,74,133,200,107,27,52,50,41,005,021602,3,410050216023
"Block Group 1, Census Tract 216.02, Clackamas County, Oregon",823,565,258,823,220,603,823,81,97,34,52,30,6,141,0,42,76,63,29,104,21,40,7,41,005,021602,1,410050216021
"Block Group 2, Census Tract 219, Clackamas County, Oregon",466,412,54,466,80,386,466,0,0,9,34,62,10,10,45,15,66,89,66,20,24,9,7,41,005,021900,2,410050219002
"Block Group 4, Census Tract 202, Clackamas County, Oregon",878,695,183,878,25,853,878,14,15,17,58,14,0,23,18,16,24,13,111,97,71,107,280,41,005,020200,4,410050202004
"Block Group 2, Census Tract 202, Clackamas County, Oregon",508,439,69,508,0,508,508,0,0,15,0,14,0,0,13,0,13,39,60,54,59,106,135,41,005,020200,2,410050202002
"Block Group 1, Census Tract 217, Clackamas County, Oregon",1080,801,279,1080,73,1007,1080,28,0,75,29,30,35,0,85,30,60,136,196,90,162,109,15,41,005,021700,1,410050217001
"Block Group 2, Census Tract 217, Clackamas County, Oregon",802,459,343,802,134,668,802,117,15,62,60,61,28,15,11,9,137,64,14,0,126,7,76,41,005,021700,2,410050217002
"Block Group 2, Census Tract 9514, Umatilla County, Oregon",306,232,74,306,46,260,306,23,11,33,9,12,6,5,9,7,43,53,23,54,12,0,6,41,059,951400,2,410599514002
"Block Group 3, Census Tract 9503, Umatilla County, Oregon",483,348,135,483,76,407,483,19,38,20,26,16,26,1,7,25,34,80,75,58,28,24,6,41,059,950300,3,410599503003
"Block Group 2, Census Tract 9503, Umatilla County, Oregon",324,269,55,324,42,282,324,27,9,5,14,0,5,11,19,12,31,85,49,22,5,14,16,41,059,950300,2,410599503002
"Block Group 5, Census Tract 9504, Umatilla County, Oregon",378,272,106,378,131,247,378,0,18,9,20,0,9,5,9,13,56,77,9,47,40,24,42,41,059,950400,5,410599504005
"Block Group 6, Census Tract 9504, Umatilla County, Oregon",275,267,8,275,21,254,275,0,0,0,7,21,0,10,14,21,34,58,44,23,0,27,16,41,059,950400,6,410599504006
"Block Group 1, Census Tract 9504, Umatilla County, Oregon",167,125,42,167,12,155,167,16,14,8,3,1,2,10,11,6,29,14,21,6,4,12,10,41,059,950400,1,410599504001
"Block Group 3, Census Tract 9504, Umatilla County, Oregon",404,199,205,404,183,221,404,58,56,43,8,0,36,0,30,18,59,16,33,11,22,0,14,41,059,950400,3,410599504003
"Block Group 4, Census Tract 9506, Umatilla County, Oregon",390,344,46,390,147,243,390,68,0,25,0,15,95,36,0,6,12,40,54,39,0,0,0,41,059,950600,4,410599506004
"Block Group 2, Census Tract 9506, Umatilla County, Oregon",242,207,35,242,100,142,242,47,9,52,0,0,50,25,0,12,0,38,0,9,0,0,0,41,059,950600,2,410599506002
"Block Group 2, Census Tract 312, Washington County, Oregon",260,228,32,260,52,208,260,0,16,0,16,18,52,16,13,0,80,0,0,13,0,36,0,41,067,031200,2,410670312002
"Block Group 2, Census Tract 316.06, Washington County, Oregon",583,561,22,583,35,548,583,9,0,0,59,13,26,13,61,18,61,50,133,15,75,50,0,41,067,031606,2,410670316062
"Block Group 1, Census Tract 316.06, Washington County, Oregon",825,698,127,825,152,673,825,0,49,44,20,65,53,0,9,27,32,64,212,111,0,126,13,41,067,031606,1,410670316061
"Block Group 3, Census Tract 316.06, Washington County, Oregon",805,709,96,805,117,688,805,18,36,77,15,21,0,14,21,35,59,62,162,108,68,32,77,41,067,031606,3,410670316063
"Block Group 1, Census Tract 316.13, Washington County, Oregon",543,471,72,543,12,531,543,12,25,0,12,11,0,0,0,78,34,49,77,158,0,62,25,41,067,031613,1,410670316131
"Block Group 2, Census Tract 9704, Union County, Oregon",542,343,199,542,181,361,542,51,10,82,16,16,12,10,28,28,24,24,122,56,0,16,47,41,061,970400,2,410619704002
"Block Group 1, Census Tract 9704, Union County, Oregon",362,284,78,362,3,359,362,9,0,1,3,0,18,8,7,24,20,34,94,42,51,18,33,41,061,970400,1,410619704001
"Block Group 2, Census Tract 9704, Columbia County, Oregon",520,336,184,520,71,449,520,5,16,22,22,20,14,29,19,12,101,44,75,67,23,31,20,41,009,970400,2,410099704002
"Block Group 1, Census Tract 9704, Columbia County, Oregon",410,268,142,410,96,314,410,40,19,44,6,6,21,19,31,14,16,47,46,59,31,11,0,41,009,970400,1,410099704001
"Block Group 6, Census Tract 304.01, Linn County, Oregon",254,91,163,254,158,96,254,18,0,18,20,64,21,51,22,0,16,0,15,0,0,9,0,41,043,030401,6,410430304016
"Block Group 1, Census Tract 304.01, Linn County, Oregon",599,307,292,599,154,445,599,12,17,0,18,83,10,20,11,74,19,162,25,36,12,42,58,41,043,030401,1,410430304011
"Block Group 3, Census Tract 307, Linn County, Oregon",411,288,123,411,17,394,411,9,11,27,29,46,12,42,36,0,54,8,26,22,34,43,12,41,043,030700,3,410430307003
"Block Group 4, Census Tract 307, Linn County, Oregon",618,472,146,618,87,531,618,17,65,22,26,28,13,4,34,16,16,122,112,59,15,24,45,41,043,030700,4,410430307004
"Block Group 3, Census Tract 37.01, Multnomah County, Oregon",610,507,103,610,115,495,610,8,66,56,10,34,10,16,14,4,49,93,81,19,88,31,31,41,051,003701,3,410510037013
"Block Group 3, Census Tract 317.03, Washington County, Oregon",750,694,56,750,75,675,750,9,34,43,8,0,21,10,30,49,93,142,101,90,37,32,51,41,067,031703,3,410670317033
"Block Group 1, Census Tract 318.05, Washington County, Oregon",541,486,55,541,116,425,541,12,0,0,0,36,37,0,0,0,45,57,182,51,52,69,0,41,067,031805,1,410670318051
"Block Group 4, Census Tract 318.05, Washington County, Oregon",511,438,73,511,51,460,511,0,11,24,0,24,20,0,24,0,53,10,60,67,52,119,47,41,067,031805,4,410670318054
"Block Group 1, Census Tract 321.03, Washington County, Oregon",872,781,91,872,0,872,872,0,0,0,80,14,16,0,0,0,15,51,91,83,124,217,181,41,067,032103,1,410670321031
"Block Group 2, Census Tract 321.03, Washington County, Oregon",1556,1193,363,1556,105,1451,1556,15,67,56,54,57,113,79,72,44,130,236,207,166,85,93,82,41,067,032103,2,410670321032
"Block Group 3, Census Tract 326.03, Washington County, Oregon",591,496,95,591,58,533,591,0,0,0,44,24,58,0,0,13,57,41,77,117,77,66,17,41,067,032603,3,410670326033
"Block Group 1, Census Tract 326.03, Washington County, Oregon",425,373,52,425,71,354,425,0,0,17,67,0,0,0,0,19,24,13,147,61,40,20,17,41,067,032603,1,410670326031
"Block Group 1, Census Tract 244, Clackamas County, Oregon",1248,1100,148,1248,101,1147,1248,16,0,18,70,29,46,51,14,21,182,110,220,191,94,71,115,41,005,024400,1,410050244001
"Block Group 3, Census Tract 244, Clackamas County, Oregon",1570,1088,482,1570,153,1417,1570,158,71,43,101,55,114,69,31,66,155,129,123,111,62,136,146,41,005,024400,3,410050244003
"Block Group 2, Census Tract 244, Clackamas County, Oregon",500,486,14,500,0,500,500,0,0,0,0,20,0,21,0,80,50,158,14,64,23,27,43,41,005,024400,2,410050244002
"Block Group 2, Census Tract 21.02, Marion County, Oregon",293,217,76,293,29,264,293,14,15,0,0,0,15,0,16,0,0,0,104,72,30,27,0,41,047,002102,2,410470021022
"Block Group 3, Census Tract 21.02, Marion County, Oregon",704,563,141,704,44,660,704,70,20,0,39,31,29,85,13,15,68,66,164,32,37,35,0,41,047,002102,3,410470021023
"Block Group 4, Census Tract 21.02, Marion County, Oregon",764,480,284,764,159,605,764,0,44,68,53,64,103,12,44,15,52,40,69,95,54,51,0,41,047,002102,4,410470021024
"Block Group 1, Census Tract 21.02, Marion County, Oregon",642,530,112,642,102,540,642,0,0,30,17,16,89,0,39,40,76,49,78,100,34,19,55,41,047,002102,1,410470021021
"Block Group 2, Census Tract 23.03, Marion County, Oregon",763,601,162,763,130,633,763,33,0,23,0,27,60,62,26,65,28,157,55,77,49,28,73,41,047,002303,2,410470023032
"Block Group 3, Census Tract 9503.04, Lincoln County, Oregon",690,424,266,690,177,513,690,31,92,42,51,51,9,105,26,25,36,86,64,34,20,18,0,41,041,950304,3,410419503043
"Block Group 1, Census Tract 9503.03, Lincoln County, Oregon",464,271,193,464,54,410,464,25,34,9,15,14,8,7,17,13,62,46,70,84,33,27,0,41,041,950303,1,410419503031
"Block Group 2, Census Tract 9503.03, Lincoln County, Oregon",278,179,99,278,32,246,278,24,26,26,2,8,16,17,4,19,32,7,46,32,5,14,0,41,041,950303,2,410419503032
"Block Group 3, Census Tract 220, Clackamas County, Oregon",902,634,268,902,139,763,902,0,17,18,20,104,0,39,41,0,93,179,64,129,94,70,34,41,005,022000,3,410050220003
"Block Group 4, Census Tract 228, Clackamas County, Oregon",319,249,70,319,67,252,319,0,56,2,0,52,0,0,0,16,31,27,12,2,0,105,16,41,005,022800,4,410050228004
"Block Group 5, Census Tract 202, Clackamas County, Oregon",574,376,198,574,19,555,574,35,0,34,46,13,28,53,20,32,28,43,80,38,13,71,40,41,005,020200,5,410050202005
"Block Group 2, Census Tract 67.01, Multnomah County, Oregon",621,449,172,621,44,577,621,49,0,13,9,31,22,0,16,10,76,54,59,75,81,70,56,41,051,006701,2,410510067012
"Block Group 5, Census Tract 53, Polk County, Oregon",1110,938,172,1110,33,1077,1110,18,0,0,0,18,38,18,34,31,77,68,187,175,185,181,80,41,053,005300,5,410530053005
"Block Group 2, Census Tract 203.04, Polk County, Oregon",579,422,157,579,207,372,579,40,31,77,52,0,34,39,53,15,0,75,112,18,33,0,0,41,053,020304,2,410530203042
"Block Group 1, Census Tract 203.04, Polk County, Oregon",638,550,88,638,181,457,638,108,60,42,23,99,69,0,22,0,78,55,38,34,0,10,0,41,053,020304,1,410530203041
"Block Group 2, Census Tract 203.03, Polk County, Oregon",615,453,162,615,104,511,615,122,97,34,20,37,29,57,13,0,33,52,51,34,11,7,18,41,053,020303,2,410530203032
"Block Group 2, Census Tract 205, Polk County, Oregon",1168,676,492,1168,61,1107,1168,2,32,70,14,73,15,20,16,63,115,182,207,202,55,55,47,41,053,020500,2,410530205002
"Block Group 3, Census Tract 96.05, Multnomah County, Oregon",797,539,258,797,271,526,797,52,137,15,103,16,8,70,73,7,47,111,71,37,20,0,30,41,051,009605,3,410510096053
"Block Group 1, Census Tract 104.11, Multnomah County, Oregon",568,353,215,568,120,448,568,34,61,9,30,35,52,73,42,25,49,77,42,32,0,7,0,41,051,010411,1,410510104111
"Block Group 2, Census Tract 64.03, Multnomah County, Oregon",948,762,186,948,137,811,948,60,40,53,21,41,51,77,3,9,91,112,161,53,44,109,23,41,051,006403,2,410510064032
"Block Group 3, Census Tract 64.03, Multnomah County, Oregon",437,384,53,437,46,391,437,11,53,60,10,42,10,0,19,0,55,35,50,31,16,30,15,41,051,006403,3,410510064033
"Block Group 1, Census Tract 104.10, Multnomah County, Oregon",633,501,132,633,180,453,633,0,46,31,59,39,60,57,17,10,132,72,71,16,23,0,0,41,051,010410,1,410510104101
"Block Group 3, Census Tract 104.10, Multnomah County, Oregon",333,246,87,333,106,227,333,22,35,10,29,20,9,9,29,9,72,0,24,46,19,0,0,41,051,010410,3,410510104103
"Block Group 1, Census Tract 9604, Tillamook County, Oregon",291,186,105,291,16,275,291,0,0,0,0,15,42,15,51,0,0,0,26,43,55,13,31,41,057,960400,1,410579604001
"Block Group 3, Census Tract 9604, Tillamook County, Oregon",745,436,309,745,217,528,745,59,27,77,14,0,90,9,57,94,69,132,62,32,10,13,0,41,057,960400,3,410579604003
"Block Group 3, Census Tract 9605, Tillamook County, Oregon",274,213,61,274,86,188,274,23,0,19,3,65,22,33,12,0,5,29,24,32,0,3,4,41,057,960500,3,410579605003
"Block Group 1, Census Tract 9605, Tillamook County, Oregon",215,146,69,215,62,153,215,10,5,4,19,16,34,0,5,25,36,22,20,10,9,0,0,41,057,960500,1,410579605001
"Block Group 2, Census Tract 9607, Tillamook County, Oregon",259,176,83,259,56,203,259,0,50,26,0,17,40,9,49,7,10,25,8,0,10,0,8,41,057,960700,2,410579607002
"Block Group 1, Census Tract 305.01, Yamhill County, Oregon",535,378,157,535,89,446,535,8,9,39,32,50,12,17,0,16,44,8,25,111,115,21,28,41,071,030501,1,410710305011
"Block Group 3, Census Tract 305.01, Yamhill County, Oregon",833,608,225,833,170,663,833,16,63,60,78,9,0,57,37,31,71,138,142,90,27,0,14,41,071,030501,3,410710305013
"Block Group 1, Census Tract 307.02, Yamhill County, Oregon",745,617,128,745,97,648,745,0,65,21,0,0,78,13,16,16,106,107,107,89,56,12,59,41,071,030702,1,410710307021
"Block Group 1, Census Tract 310, Yamhill County, Oregon",702,512,190,702,161,541,702,61,0,75,34,20,23,8,30,24,28,28,28,83,106,118,36,41,071,031000,1,410710310001
"Block Group 3, Census Tract 302.01, Yamhill County, Oregon",376,285,91,376,66,310,376,72,31,0,0,70,25,0,30,0,38,30,45,17,0,0,18,41,071,030201,3,410710302013
"Block Group 4, Census Tract 302.01, Yamhill County, Oregon",606,404,202,606,0,606,606,15,0,49,58,20,40,26,78,36,74,40,32,113,12,0,13,41,071,030201,4,410710302014
"Block Group 2, Census Tract 302.01, Yamhill County, Oregon",547,456,91,547,44,503,547,41,0,0,33,27,31,0,0,0,191,67,70,22,49,16,0,41,071,030201,2,410710302012
"Block Group 2, Census Tract 105.03, Marion County, Oregon",348,280,68,348,39,309,348,14,0,9,14,14,57,10,41,19,33,55,50,12,5,15,0,41,047,010503,2,410470105032
"Block Group 3, Census Tract 105.03, Marion County, Oregon",708,541,167,708,32,676,708,18,0,11,49,36,17,14,22,8,47,139,120,132,16,31,48,41,047,010503,3,410470105033
"Block Group 2, Census Tract 107.01, Marion County, Oregon",621,511,110,621,82,539,621,12,34,21,13,0,13,16,22,34,48,53,185,103,16,15,36,41,047,010701,2,410470107012
"Block Group 5, Census Tract 107.01, Marion County, Oregon",692,433,259,692,62,630,692,28,68,54,140,17,34,30,13,0,21,67,85,108,0,17,10,41,047,010701,5,410470107015
"Block Group 1, Census Tract 52.01, Polk County, Oregon",242,195,47,242,102,140,242,0,16,11,19,0,0,38,0,20,0,12,0,71,15,40,0,41,053,005201,1,410530052011
"Block Group 3, Census Tract 52.01, Polk County, Oregon",1478,987,491,1478,283,1195,1478,54,37,61,46,186,133,26,0,15,125,142,174,253,65,39,122,41,053,005201,3,410530052013
"Block Group 1, Census Tract 202.04, Polk County, Oregon",443,343,100,443,55,388,443,18,10,8,10,19,22,26,19,0,54,55,95,62,0,37,8,41,053,020204,1,410530202041
"Block Group 2, Census Tract 202.04, Polk County, Oregon",481,339,142,481,68,413,481,0,0,10,10,19,11,10,32,13,22,74,70,95,34,39,42,41,053,020204,2,410530202042
"Block Group 1, Census Tract 51, Polk County, Oregon",394,298,96,394,175,219,394,36,65,17,21,0,64,48,6,11,32,46,21,13,14,0,0,41,053,005100,1,410530051001
"Block Group 3, Census Tract 105.01, Marion County, Oregon",736,532,204,736,100,636,736,16,0,31,22,95,76,0,0,31,69,25,124,19,64,91,73,41,047,010501,3,410470105013
"Block Group 1, Census Tract 105.01, Marion County, Oregon",575,430,145,575,8,567,575,24,6,5,5,2,95,12,0,10,33,62,47,143,1,107,23,41,047,010501,1,410470105011
"Block Group 5, Census Tract 3.02, Multnomah County, Oregon",403,316,87,403,0,403,403,15,14,0,0,0,0,0,0,0,0,29,18,59,40,0,228,41,051,000302,5,410510003025
"Block Group 2, Census Tract 3.02, Multnomah County, Oregon",580,460,120,580,22,558,580,14,0,0,54,14,0,18,0,0,47,0,59,85,43,77,169,41,051,000302,2,410510003022
"Block Group 6, Census Tract 3.02, Multnomah County, Oregon",393,309,84,393,0,393,393,0,0,0,0,13,0,0,0,0,33,0,59,59,28,14,187,41,051,000302,6,410510003026
"Block Group 4, Census Tract 3.02, Multnomah County, Oregon",488,434,54,488,19,469,488,0,13,0,0,0,0,0,0,14,0,14,107,76,68,105,91,41,051,000302,4,410510003024
"Block Group 2, Census Tract 5.01, Multnomah County, Oregon",438,370,68,438,92,346,438,27,0,28,10,10,7,10,7,18,57,79,58,69,8,13,37,41,051,000501,2,410510005012
"Block Group 4, Census Tract 5.01, Multnomah County, Oregon",395,329,66,395,96,299,395,21,27,0,0,0,9,11,0,46,46,7,105,31,50,42,0,41,051,000501,4,410510005014
"Block Group 1, Census Tract 5.01, Multnomah County, Oregon",344,292,52,344,108,236,344,43,10,24,36,31,10,0,0,15,8,37,50,43,24,5,8,41,051,000501,1,410510005011
"Block Group 3, Census Tract 5.01, Multnomah County, Oregon",518,447,71,518,58,460,518,37,10,0,28,27,8,0,32,18,56,60,79,76,26,46,15,41,051,000501,3,410510005013
"Block Group 3, Census Tract 13.02, Multnomah County, Oregon",601,545,56,601,44,557,601,36,0,11,0,19,0,0,0,0,9,119,135,90,28,23,131,41,051,001302,3,410510013023
"Block Group 2, Census Tract 13.02, Multnomah County, Oregon",526,480,46,526,41,485,526,51,13,8,0,20,0,12,8,43,29,76,54,100,35,22,55,41,051,001302,2,410510013022
"Block Group 1, Census Tract 13.02, Multnomah County, Oregon",354,309,45,354,65,289,354,31,0,0,16,23,0,11,44,14,9,47,17,47,20,33,42,41,051,001302,1,410510013021
"Block Group 1, Census Tract 24.01, Multnomah County, Oregon",533,500,33,533,10,523,533,18,0,0,5,0,0,9,7,7,53,26,69,0,76,75,188,41,051,002401,1,410510024011
"Block Group 2, Census Tract 24.01, Multnomah County, Oregon",246,219,27,246,8,238,246,8,0,0,0,0,5,7,18,12,0,34,33,18,36,46,29,41,051,002401,2,410510024012
"Block Group 4, Census Tract 9501, Crook County, Oregon",250,153,97,250,118,132,250,14,0,0,0,42,17,57,17,0,0,62,13,0,19,0,9,41,013,950100,4,410139501004
"Block Group 3, Census Tract 9501, Crook County, Oregon",1634,981,653,1634,349,1285,1634,72,69,53,29,110,266,64,116,27,53,213,224,175,86,77,0,41,013,950100,3,410139501003
"Block Group 2, Census Tract 316.13, Washington County, Oregon",254,231,23,254,28,226,254,0,0,0,0,36,0,0,0,0,35,105,37,41,0,0,0,41,067,031613,2,410670316132
"Block Group 4, Census Tract 316.13, Washington County, Oregon",1502,1267,235,1502,297,1205,1502,163,0,60,46,35,16,148,37,66,33,199,272,193,119,68,47,41,067,031613,4,410670316134
"Block Group 3, Census Tract 316.13, Washington County, Oregon",677,563,114,677,193,484,677,15,12,18,14,48,8,43,30,0,30,51,139,144,57,51,17,41,067,031613,3,410670316133
"Block Group 2, Census Tract 318.07, Washington County, Oregon",722,520,202,722,8,714,722,8,8,8,15,6,6,9,8,23,16,93,116,126,89,51,140,41,067,031807,2,410670318072
"Block Group 1, Census Tract 318.07, Washington County, Oregon",861,619,242,861,102,759,861,111,61,69,25,10,30,59,29,31,68,79,63,70,91,65,0,41,067,031807,1,410670318071
"Block Group 5, Census Tract 324.04, Washington County, Oregon",588,535,53,588,136,452,588,0,0,20,25,0,72,0,12,29,52,107,39,82,32,110,8,41,067,032404,5,410670324045
"Block Group 4, Census Tract 324.04, Washington County, Oregon",971,824,147,971,108,863,971,12,18,18,0,0,0,0,33,37,118,165,255,161,26,81,47,41,067,032404,4,410670324044
"Block Group 2, Census Tract 324.04, Washington County, Oregon",446,379,67,446,30,416,446,17,0,0,11,0,0,0,28,0,106,56,58,119,26,21,4,41,067,032404,2,410670324042
"Block Group 1, Census Tract 319.04, Washington County, Oregon",449,355,94,449,32,417,449,13,0,0,8,7,10,0,19,9,23,44,64,69,77,90,16,41,067,031904,1,410670319041
"Block Group 1, Census Tract 309, Washington County, Oregon",894,824,70,894,133,761,894,53,0,82,70,94,44,13,39,100,0,70,180,97,33,9,10,41,067,030900,1,410670309001
"Block Group 1, Census Tract 315.12, Washington County, Oregon",257,171,86,257,0,257,257,0,17,0,0,13,13,0,12,0,0,11,24,68,26,58,15,41,067,031512,1,410670315121
"Block Group 2, Census Tract 315.12, Washington County, Oregon",1121,966,155,1121,96,1025,1121,38,14,16,41,49,14,0,18,15,36,81,172,191,94,160,182,41,067,031512,2,410670315122
"Block Group 2, Census Tract 9702, Morrow County, Oregon",229,172,57,229,47,182,229,26,5,2,7,13,12,10,26,3,24,27,23,24,18,1,8,41,049,970200,2,410499702002
"Block Group 1, Census Tract 9702, Morrow County, Oregon",167,118,49,167,16,151,167,0,8,11,6,21,2,6,3,6,41,14,16,11,5,1,16,41,049,970200,1,410499702001
"Block Group 6, Census Tract 9702, Morrow County, Oregon",179,103,76,179,22,157,179,0,13,5,12,11,3,6,1,0,2,17,53,9,2,24,21,41,049,970200,6,410499702006
"Block Group 1, Census Tract 9701, Morrow County, Oregon",789,647,142,789,221,568,789,47,8,54,26,18,50,51,24,70,86,102,125,45,16,57,10,41,049,970100,1,410499701001
"Block Group 3, Census Tract 9504, Hood River County, Oregon",607,559,48,607,115,492,607,6,0,0,9,75,15,73,50,12,94,101,72,13,31,21,35,41,027,950400,3,410279504003
"Block Group 2, Census Tract 9602, Lake County, Oregon",226,81,145,226,36,190,226,44,0,0,53,17,14,26,10,0,17,14,14,12,0,0,5,41,037,960200,2,410379602002
"Block Group 4, Census Tract 9602, Lake County, Oregon",316,250,66,316,33,283,316,10,38,14,7,0,29,8,17,33,20,75,24,25,11,5,0,41,037,960200,4,410379602004
"Block Group 3, Census Tract 9602, Lake County, Oregon",336,220,116,336,128,208,336,56,36,15,54,3,9,4,0,22,6,30,40,20,10,26,5,41,037,960200,3,410379602003
"Block Group 5, Census Tract 9602, Lake County, Oregon",404,314,90,404,101,303,404,45,8,0,63,40,34,15,20,20,22,43,24,18,15,21,16,41,037,960200,5,410379602005
"Block Group 2, Census Tract 9601, Lake County, Oregon",441,332,109,441,60,381,441,32,21,24,25,21,16,46,18,7,54,54,82,29,5,0,7,41,037,960100,2,410379601002
"Block Group 1, Census Tract 9601, Lake County, Oregon",954,538,416,954,179,775,954,143,21,138,46,110,138,33,83,6,48,30,63,19,24,21,31,41,037,960100,1,410379601001
"Block Group 2, Census Tract 3.01, Multnomah County, Oregon",273,208,65,273,0,273,273,0,0,0,0,16,16,17,0,13,33,16,48,17,49,13,35,41,051,000301,2,410510003012
"Block Group 3, Census Tract 2, Multnomah County, Oregon",726,588,138,726,32,694,726,34,29,30,0,89,0,0,14,15,62,68,161,0,42,66,116,41,051,000200,3,410510002003
"Block Group 4, Census Tract 2, Multnomah County, Oregon",911,554,357,911,364,547,911,291,138,13,0,43,0,0,16,76,0,54,140,60,19,0,61,41,051,000200,4,410510002004
"Block Group 2, Census Tract 4.02, Multnomah County, Oregon",345,287,58,345,10,335,345,0,0,0,0,40,7,0,32,0,79,68,43,35,19,22,0,41,051,000402,2,410510004022
"Block Group 3, Census Tract 4.02, Multnomah County, Oregon",627,546,81,627,115,512,627,18,12,18,0,20,10,27,28,73,49,34,196,51,22,59,10,41,051,000402,3,410510004023
"Block Group 1, Census Tract 11.02, Multnomah County, Oregon",676,612,64,676,57,619,676,56,21,21,14,29,23,34,16,19,34,58,116,46,50,61,78,41,051,001102,1,410510011021
"Block Group 3, Census Tract 15, Multnomah County, Oregon",308,265,43,308,40,268,308,0,0,11,37,0,0,17,0,11,11,3,45,32,38,50,53,41,051,001500,3,410510015003
"Block Group 2, Census Tract 15, Multnomah County, Oregon",469,418,51,469,42,427,469,8,18,10,58,0,6,13,0,48,54,36,41,35,24,50,68,41,051,001500,2,410510015002
"Block Group 1, Census Tract 76, Multnomah County, Oregon",531,360,171,531,124,407,531,11,31,14,52,21,41,37,35,0,31,71,79,20,65,23,0,41,051,007600,1,410510076001
"Block Group 2, Census Tract 76, Multnomah County, Oregon",813,676,137,813,191,622,813,91,10,12,102,64,96,6,7,69,64,81,111,57,23,10,10,41,051,007600,2,410510076002
"Block Group 2, Census Tract 77, Multnomah County, Oregon",380,332,48,380,64,316,380,29,3,2,6,29,8,30,16,57,14,59,45,50,21,0,11,41,051,007700,2,410510077002
"Block Group 2, Census Tract 81, Multnomah County, Oregon",673,557,116,673,154,519,673,39,15,29,73,13,0,34,61,45,134,103,34,72,0,21,0,41,051,008100,2,410510081002
"Block Group 4, Census Tract 81, Multnomah County, Oregon",826,649,177,826,137,689,826,30,72,73,0,15,90,0,92,44,106,37,38,83,135,11,0,41,051,008100,4,410510081004
"Block Group 1, Census Tract 9706, Malheur County, Oregon",331,280,51,331,66,265,331,8,8,7,0,6,7,88,0,8,32,38,26,84,10,9,0,41,045,970600,1,410459706001
"Block Group 3, Census Tract 9706, Malheur County, Oregon",325,265,60,325,96,229,325,11,25,54,25,34,17,2,9,10,34,28,24,13,20,17,2,41,045,970600,3,410459706003
"Block Group 2, Census Tract 303.02, Yamhill County, Oregon",435,332,103,435,19,416,435,5,11,3,0,12,16,17,0,9,18,47,46,59,21,53,118,41,071,030302,2,410710303022
"Block Group 1, Census Tract 303.02, Yamhill County, Oregon",332,263,69,332,24,308,332,28,0,5,0,14,5,12,6,8,6,14,46,9,38,55,86,41,071,030302,1,410710303021
"Block Group 1, Census Tract 301.02, Yamhill County, Oregon",368,253,115,368,24,344,368,45,0,15,0,0,0,0,15,0,64,11,31,99,49,39,0,41,071,030102,1,410710301021
"Block Group 3, Census Tract 301.02, Yamhill County, Oregon",1138,829,309,1138,97,1041,1138,146,0,106,32,0,71,19,32,56,75,131,83,170,98,20,99,41,071,030102,3,410710301023
"Block Group 1, Census Tract 306.01, Yamhill County, Oregon",515,365,150,515,213,302,515,48,37,51,11,0,28,9,59,12,107,46,34,52,8,9,4,41,071,030601,1,410710306011
"Block Group 2, Census Tract 306.01, Yamhill County, Oregon",673,283,390,673,81,592,673,39,19,82,53,21,53,39,29,24,143,67,43,26,17,18,0,41,071,030601,2,410710306012
"Block Group 1, Census Tract 301.01, Yamhill County, Oregon",1133,813,320,1133,155,978,1133,50,39,23,0,25,15,108,36,79,72,158,137,123,115,103,50,41,071,030101,1,410710301011
"Block Group 1, Census Tract 303.01, Yamhill County, Oregon",158,98,60,158,13,145,158,0,26,0,0,23,0,0,0,0,10,0,22,0,0,50,27,41,071,030301,1,410710303011
"Block Group 2, Census Tract 303.01, Yamhill County, Oregon",1429,1305,124,1429,294,1135,1429,20,0,27,23,46,100,174,19,31,98,184,299,186,32,127,63,41,071,030301,2,410710303012
"Block Group 2, Census Tract 204.04, Clackamas County, Oregon",663,496,167,663,8,655,663,0,0,16,0,18,0,0,57,35,6,0,57,52,56,100,266,41,005,020404,2,410050204042
"Block Group 1, Census Tract 204.04, Clackamas County, Oregon",776,632,144,776,0,776,776,10,24,9,9,25,8,0,28,0,18,28,34,61,85,139,298,41,005,020404,1,410050204041
"Block Group 3, Census Tract 309, Washington County, Oregon",679,536,143,679,228,451,679,56,26,132,39,29,0,30,51,38,85,99,34,19,0,31,10,41,067,030900,3,410670309003
"Block Group 2, Census Tract 309, Washington County, Oregon",725,675,50,725,104,621,725,39,57,0,38,0,24,41,11,92,92,84,76,93,22,0,56,41,067,030900,2,410670309002
"Block Group 4, Census Tract 9603.02, Jefferson County, Oregon",776,628,148,776,149,627,776,24,9,23,32,35,105,62,52,37,77,66,112,52,39,32,19,41,031,960302,4,410319603024
"Block Group 3, Census Tract 9603.02, Jefferson County, Oregon",258,183,75,258,58,200,258,13,14,0,21,6,0,0,6,0,76,54,26,28,0,8,6,41,031,960302,3,410319603023
"Block Group 1, Census Tract 230.01, Clackamas County, Oregon",855,713,142,855,55,800,855,22,0,10,8,16,13,75,19,11,43,72,125,127,89,69,156,41,005,023001,1,410050230011
"Block Group 5, Census Tract 9501, Crook County, Oregon",383,295,88,383,117,266,383,26,37,14,34,0,55,0,45,36,0,73,55,8,0,0,0,41,013,950100,5,410139501005
"Block Group 2, Census Tract 9502, Crook County, Oregon",476,289,187,476,58,418,476,9,0,0,26,15,57,15,0,49,26,86,129,56,8,0,0,41,013,950200,2,410139502002
"Block Group 4, Census Tract 9502, Crook County, Oregon",391,218,173,391,102,289,391,19,55,46,16,11,103,33,6,0,13,17,36,6,0,22,8,41,013,950200,4,410139502004
"Block Group 2, Census Tract 9503, Crook County, Oregon",541,274,267,541,176,365,541,0,63,33,87,69,37,30,0,0,64,34,84,40,0,0,0,41,013,950300,2,410139503002
"Block Group 4, Census Tract 9503, Crook County, Oregon",257,163,94,257,96,161,257,27,0,0,28,0,34,81,0,19,14,25,12,17,0,0,0,41,013,950300,4,410139503004
"Block Group 5, Census Tract 9503, Crook County, Oregon",965,682,283,965,199,766,965,32,26,0,0,0,15,127,63,0,28,68,197,97,28,132,152,41,013,950300,5,410139503005
"Block Group 2, Census Tract 9501, Sherman County, Oregon",375,251,124,375,66,309,375,16,20,26,31,14,12,13,28,16,42,56,39,33,5,10,14,41,055,950100,2,410559501002
"Block Group 1, Census Tract 9501, Sherman County, Oregon",373,289,84,373,58,315,373,13,22,18,28,21,43,6,17,18,27,59,39,20,17,6,19,41,055,950100,1,410559501001
"Block Group 3, Census Tract 9702, Wasco County, Oregon",493,350,143,493,170,323,493,27,56,26,16,21,39,25,59,27,37,56,65,0,35,4,0,41,065,970200,3,410659702003
"Block Group 2, Census Tract 9705, Wasco County, Oregon",647,486,161,647,252,395,647,38,51,48,39,45,36,15,71,36,57,103,63,38,7,0,0,41,065,970500,2,410659705002
"Block Group 3, Census Tract 9705, Wasco County, Oregon",458,320,138,458,167,291,458,37,16,43,18,29,0,52,44,51,40,18,19,15,76,0,0,41,065,970500,3,410659705003
"Block Group 2, Census Tract 9707, Wasco County, Oregon",437,333,104,437,25,412,437,4,3,51,11,18,4,16,8,29,60,61,48,59,22,15,28,41,065,970700,2,410659707002
"Block Group 1, Census Tract 39, Lane County, Oregon",456,269,187,456,101,355,456,89,69,8,41,24,31,22,41,19,15,18,34,6,12,10,17,41,039,003900,1,410390039001
"Block Group 3, Census Tract 39, Lane County, Oregon",511,336,175,511,207,304,511,52,113,45,50,34,28,9,30,18,33,76,7,10,0,0,6,41,039,003900,3,410390039003
"Block Group 2, Census Tract 11, Coos County, Oregon",227,113,114,227,44,183,227,18,47,0,15,26,28,12,0,0,45,12,0,13,0,11,0,41,011,001100,2,410110011002
"Block Group 6, Census Tract 11, Coos County, Oregon",388,279,109,388,147,241,388,83,16,5,16,14,69,0,24,0,22,32,36,0,58,0,13,41,011,001100,6,410110011006
"Block Group 3, Census Tract 11, Coos County, Oregon",345,200,145,345,71,274,345,59,5,20,38,22,0,20,29,0,21,28,49,27,21,0,6,41,011,001100,3,410110011003
"Block Group 5, Census Tract 11, Coos County, Oregon",350,243,107,350,67,283,350,45,15,29,5,36,27,16,6,0,9,11,55,19,49,14,14,41,011,001100,5,410110011005
"Block Group 2, Census Tract 6, Coos County, Oregon",274,223,51,274,77,197,274,7,32,11,0,0,11,8,43,0,0,46,22,18,15,12,49,41,011,000600,2,410110006002
"Block Group 1, Census Tract 6, Coos County, Oregon",352,220,132,352,71,281,352,35,9,0,8,51,0,20,20,0,20,26,64,41,18,35,5,41,011,000600,1,410110006001
"Block Group 2, Census Tract 3, Coos County, Oregon",279,238,41,279,28,251,279,17,0,0,31,8,28,7,0,32,17,21,41,25,11,11,30,41,011,000300,2,410110003002
"Block Group 1, Census Tract 63, Multnomah County, Oregon",607,476,131,607,8,599,607,26,15,6,12,0,8,18,0,27,46,13,26,79,56,79,196,41,051,006300,1,410510063001
"Block Group 2, Census Tract 64.02, Multnomah County, Oregon",1003,868,135,1003,29,974,1003,32,6,10,18,0,0,53,17,0,37,61,82,74,84,182,347,41,051,006402,2,410510064022
"Block Group 3, Census Tract 70, Multnomah County, Oregon",330,251,79,330,13,317,330,33,0,0,0,22,32,0,0,0,14,14,16,17,13,17,152,41,051,007000,3,410510070003
"Block Group 2, Census Tract 70, Multnomah County, Oregon",769,706,63,769,16,753,769,0,0,0,20,0,0,12,38,0,34,31,36,69,27,138,364,41,051,007000,2,410510070002
"Block Group 2, Census Tract 72.01, Multnomah County, Oregon",727,553,174,727,41,686,727,24,18,18,36,7,25,41,47,9,26,31,104,111,41,119,70,41,051,007201,2,410510072012
"Block Group 3, Census Tract 38.02, Multnomah County, Oregon",416,368,48,416,4,412,416,0,12,0,4,11,0,0,19,50,30,34,71,10,46,68,61,41,051,003802,3,410510038023
"Block Group 3, Census Tract 9602.02, Jefferson County, Oregon",786,579,207,786,148,638,786,30,11,31,33,41,42,0,39,34,78,96,156,45,73,53,24,41,031,960202,3,410319602023
"Block Group 2, Census Tract 9602.02, Jefferson County, Oregon",843,628,215,843,195,648,843,39,61,83,87,37,16,76,18,39,31,38,129,47,91,38,13,41,031,960202,2,410319602022
"Block Group 2, Census Tract 9602.01, Jefferson County, Oregon",533,364,169,533,205,328,533,62,30,17,61,46,60,20,24,14,42,35,41,22,20,39,0,41,031,960201,2,410319602012
"Block Group 1, Census Tract 9602.01, Jefferson County, Oregon",784,524,260,784,450,334,784,73,119,25,95,72,58,0,81,8,12,59,89,62,0,31,0,41,031,960201,1,410319602011
"Block Group 2, Census Tract 9603.01, Jefferson County, Oregon",453,307,146,453,93,360,453,16,11,0,0,78,15,33,11,14,33,126,20,62,7,0,27,41,031,960301,2,410319603012
"Block Group 3, Census Tract 9603.01, Jefferson County, Oregon",826,526,300,826,108,718,826,26,52,12,8,64,61,20,34,48,79,130,131,104,0,29,28,41,031,960301,3,410319603013
"Block Group 1, Census Tract 9603.01, Jefferson County, Oregon",362,195,167,362,34,328,362,60,7,0,16,6,15,25,4,21,18,65,48,49,28,0,0,41,031,960301,1,410319603011
"Block Group 2, Census Tract 2.02, Benton County, Oregon",1789,1314,475,1789,59,1730,1789,155,18,26,75,105,72,76,55,116,213,140,188,171,106,99,174,41,003,000202,2,410030002022
"Block Group 1, Census Tract 2.02, Benton County, Oregon",498,448,50,498,0,498,498,0,0,0,0,0,18,0,0,0,14,58,139,51,44,115,59,41,003,000202,1,410030002021
"Block Group 2, Census Tract 107.02, Benton County, Oregon",0,0,0,0,0,0,0,0,0,0,0,0,0,0,0,0,0,0,0,0,0,0,0,41,003,010702,2,410030107022
"Block Group 3, Census Tract 107.02, Benton County, Oregon",587,420,167,587,80,507,587,144,93,91,42,24,6,49,51,13,8,23,28,0,11,4,0,41,003,010702,3,410030107023
"Block Group 1, Census Tract 107.02, Benton County, Oregon",514,365,149,514,79,435,514,53,35,55,27,49,36,24,6,5,41,32,16,36,10,41,48,41,003,010702,1,410030107021
"Block Group 5, Census Tract 9706, Malheur County, Oregon",101,64,37,101,51,50,101,20,23,0,0,8,7,0,7,0,0,0,19,17,0,0,0,41,045,970600,5,410459706005
"Block Group 2, Census Tract 9706, Malheur County, Oregon",411,331,80,411,78,333,411,46,0,45,45,39,19,7,4,18,57,27,44,18,7,26,9,41,045,970600,2,410459706002
"Block Group 4, Census Tract 9706, Malheur County, Oregon",343,254,89,343,90,253,343,22,31,2,8,24,34,54,9,12,34,59,30,17,4,3,0,41,045,970600,4,410459706004
"Block Group 1, Census Tract 9702, Malheur County, Oregon",380,326,54,380,65,315,380,6,26,0,8,6,49,38,14,15,66,22,88,24,0,11,7,41,045,970200,1,410459702001
"Block Group 3, Census Tract 9702, Malheur County, Oregon",395,285,110,395,58,337,395,0,15,8,33,29,34,8,7,28,35,55,59,44,18,0,22,41,045,970200,3,410459702003
"Block Group 4, Census Tract 9702, Malheur County, Oregon",669,368,301,669,78,591,669,34,69,27,50,38,60,86,12,10,54,43,99,31,34,0,22,41,045,970200,4,410459702004
"Block Group 2, Census Tract 9702, Malheur County, Oregon",303,252,51,303,166,137,303,0,26,29,56,23,21,12,10,17,12,44,12,7,15,10,9,41,045,970200,2,410459702002
"Block Group 1, Census Tract 9705, Malheur County, Oregon",287,255,32,287,16,271,287,8,7,0,15,24,41,22,38,0,12,53,16,6,17,28,0,41,045,970500,1,410459705001
"Block Group 6, Census Tract 9705, Malheur County, Oregon",261,214,47,261,35,226,261,0,15,42,4,29,8,4,8,17,31,35,33,35,0,0,0,41,045,970500,6,410459705006
"Block Group 4, Census Tract 9705, Malheur County, Oregon",282,235,47,282,138,144,282,14,14,30,22,6,23,50,27,34,0,32,8,17,5,0,0,41,045,970500,4,410459705004
"Block Group 5, Census Tract 9705, Malheur County, Oregon",270,208,62,270,90,180,270,40,24,0,23,0,14,0,31,3,24,50,12,46,0,0,3,41,045,970500,5,410459705005
"Block Group 3, Census Tract 9705, Malheur County, Oregon",262,237,25,262,60,202,262,13,12,18,3,15,14,44,9,37,21,18,58,0,0,0,0,41,045,970500,3,410459705003
"Block Group 2, Census Tract 9705, Malheur County, Oregon",342,214,128,342,86,256,342,63,5,11,12,0,45,21,18,4,30,57,45,11,20,0,0,41,045,970500,2,410459705002
"Block Group 2, Census Tract 1, Multnomah County, Oregon",550,423,127,550,17,533,550,16,28,0,0,32,0,20,0,17,13,42,46,13,44,133,146,41,051,000100,2,410510001002
"Block Group 2, Census Tract 6.02, Multnomah County, Oregon",884,747,137,884,198,686,884,59,116,11,89,52,34,29,30,14,65,76,154,52,46,39,18,41,051,000602,2,410510006022
"Block Group 3, Census Tract 6.02, Multnomah County, Oregon",516,476,40,516,78,438,516,8,0,21,13,0,41,0,45,0,83,87,127,36,30,8,17,41,051,000602,3,410510006023
"Block Group 1, Census Tract 6.02, Multnomah County, Oregon",283,217,66,283,21,262,283,47,0,22,7,12,0,0,46,6,29,42,58,0,0,10,4,41,051,000602,1,410510006021
"Block Group 4, Census Tract 8.01, Multnomah County, Oregon",462,403,59,462,114,348,462,0,34,16,0,10,0,71,0,0,54,27,90,58,44,28,30,41,051,000801,4,410510008014
"Block Group 2, Census Tract 74, Multnomah County, Oregon",929,826,103,929,181,748,929,10,102,31,31,77,31,40,18,12,84,149,95,133,41,61,14,41,051,007400,2,410510074002
"Block Group 1, Census Tract 7.01, Multnomah County, Oregon",637,545,92,637,121,516,637,10,24,16,18,65,29,22,0,17,40,47,58,105,59,96,31,41,051,000701,1,410510007011
"Block Group 2, Census Tract 7.01, Multnomah County, Oregon",359,308,51,359,52,307,359,18,0,10,28,18,31,0,0,42,30,22,58,41,33,19,9,41,051,000701,2,410510007012
"Block Group 2, Census Tract 16.02, Multnomah County, Oregon",421,368,53,421,26,395,421,8,0,8,8,0,13,20,11,21,49,43,88,65,26,61,0,41,051,001602,2,410510016022
"Block Group 3, Census Tract 16.02, Multnomah County, Oregon",603,449,154,603,157,446,603,71,118,0,8,38,95,0,26,0,0,109,44,27,10,57,0,41,051,001602,3,410510016023
"Block Group 4, Census Tract 16.02, Multnomah County, Oregon",328,246,82,328,86,242,328,55,23,29,19,7,21,7,37,6,20,31,21,29,9,14,0,41,051,001602,4,410510016024
"Block Group 1, Census Tract 65.01, Multnomah County, Oregon",942,812,130,942,92,850,942,0,0,0,0,32,19,0,0,15,104,81,189,61,93,114,234,41,051,006501,1,410510065011
"Block Group 1, Census Tract 79, Multnomah County, Oregon",621,545,76,621,172,449,621,26,88,24,76,41,19,8,45,16,46,116,57,44,0,15,0,41,051,007900,1,410510079001
"Block Group 2, Census Tract 82.02, Multnomah County, Oregon",1049,868,181,1049,387,662,1049,121,17,89,14,32,177,23,17,7,123,136,136,40,18,86,13,41,051,008202,2,410510082022
"Block Group 1, Census Tract 82.02, Multnomah County, Oregon",1556,1188,368,1556,224,1332,1556,67,32,81,111,105,127,96,63,108,191,219,137,127,55,17,20,41,051,008202,1,410510082021
"Block Group 2, Census Tract 83.02, Multnomah County, Oregon",830,600,230,830,307,523,830,78,66,41,20,66,41,54,82,46,52,32,144,51,57,0,0,41,051,008302,2,410510083022
"Block Group 2, Census Tract 93.02, Multnomah County, Oregon",591,349,242,591,85,506,591,53,35,21,85,18,31,11,17,21,33,77,107,22,27,7,26,41,051,009302,2,410510093022
"Block Group 2, Census Tract 97.01, Multnomah County, Oregon",482,326,156,482,127,355,482,82,0,12,34,12,24,12,0,43,36,98,42,68,0,15,4,41,051,009701,2,410510097012
"Block Group 3, Census Tract 97.01, Multnomah County, Oregon",563,444,119,563,105,458,563,0,18,36,60,34,30,32,23,27,47,35,138,22,14,47,0,41,051,009701,3,410510097013
"Block Group 2, Census Tract 103.03, Multnomah County, Oregon",831,763,68,831,61,770,831,23,13,0,17,95,14,51,65,34,153,51,89,139,32,47,8,41,051,010303,2,410510103032
"Block Group 7, Census Tract 1, Multnomah County, Oregon",497,369,128,497,14,483,497,17,0,18,14,0,26,15,0,30,20,31,203,29,15,27,52,41,051,000100,7,410510001007
"Block Group 6, Census Tract 1, Multnomah County, Oregon",408,266,142,408,17,391,408,16,0,0,0,18,18,6,0,25,46,0,130,48,43,24,34,41,051,000100,6,410510001006
"Block Group 5, Census Tract 1, Multnomah County, Oregon",355,272,83,355,30,325,355,15,0,61,0,0,16,11,10,38,23,14,69,16,43,39,0,41,051,000100,5,410510001005
"Block Group 1, Census Tract 1, Multnomah County, Oregon",346,315,31,346,0,346,346,0,0,0,13,16,0,0,52,0,0,14,11,27,9,91,113,41,051,000100,1,410510001001
"Block Group 2, Census Tract 24.04, Lane County, Oregon",845,548,297,845,195,650,845,53,6,46,21,93,16,17,58,59,63,134,160,70,25,12,12,41,039,002404,2,410390024042
"Block Group 1, Census Tract 11.02, Benton County, Oregon",328,272,56,328,14,314,328,34,0,26,34,0,0,0,42,0,77,16,25,22,33,0,19,41,003,001102,1,410030011021
"Block Group 2, Census Tract 11.02, Benton County, Oregon",655,573,82,655,94,561,655,71,104,28,74,39,38,13,21,12,34,107,29,0,70,15,0,41,003,001102,2,410030011022
"Block Group 3, Census Tract 104, Benton County, Oregon",956,725,231,956,144,812,956,63,37,27,62,76,18,24,30,60,86,69,162,53,64,117,8,41,003,010400,3,410030104003
"Block Group 1, Census Tract 104, Benton County, Oregon",348,243,105,348,1,347,348,6,0,32,9,0,0,32,27,0,26,11,54,70,13,56,12,41,003,010400,1,410030104001
"Block Group 2, Census Tract 104, Benton County, Oregon",253,189,64,253,0,253,253,0,0,8,21,31,8,0,18,10,33,0,11,46,6,27,34,41,003,010400,2,410030104002
"Block Group 3, Census Tract 101, Benton County, Oregon",969,798,171,969,18,951,969,30,30,13,0,23,45,28,35,12,63,86,95,141,118,103,147,41,003,010100,3,410030101003
"Block Group 1, Census Tract 101, Benton County, Oregon",313,216,97,313,10,303,313,0,0,26,0,12,0,0,16,0,56,28,25,41,14,52,43,41,003,010100,1,410030101001
"Block Group 2, Census Tract 101, Benton County, Oregon",898,701,197,898,14,884,898,15,18,0,13,14,28,11,17,12,18,107,230,167,110,48,90,41,003,010100,2,410030101002
"Block Group 4, Census Tract 101, Benton County, Oregon",749,477,272,749,52,697,749,16,48,37,43,18,30,0,81,0,22,57,70,134,76,76,41,41,003,010100,4,410030101004
"Block Group 5, Census Tract 101, Benton County, Oregon",597,477,120,597,0,597,597,16,0,0,30,16,0,15,0,36,0,60,48,87,61,151,77,41,003,010100,5,410030101005
"Block Group 4, Census Tract 4, Benton County, Oregon",441,272,169,441,27,414,441,25,0,13,14,0,0,15,13,0,41,45,75,80,49,29,42,41,003,000400,4,410030004004
"Block Group 1, Census Tract 4, Benton County, Oregon",1092,732,360,1092,87,1005,1092,80,0,42,25,39,58,29,33,26,136,139,234,82,43,116,10,41,003,000400,1,410030004001
"Block Group 2, Census Tract 4, Benton County, Oregon",1180,872,308,1180,129,1051,1180,48,27,0,14,0,21,78,8,32,77,86,148,130,84,212,215,41,003,000400,2,410030004002
"Block Group 3, Census Tract 4, Benton County, Oregon",725,569,156,725,32,693,725,34,13,14,55,0,0,13,28,0,88,128,18,56,47,111,120,41,003,000400,3,410030004003
"Block Group 1, Census Tract 1, Benton County, Oregon",480,453,27,480,136,344,480,32,29,41,21,0,29,13,12,11,40,70,107,25,50,0,0,41,003,000100,1,410030001001
"Block Group 3, Census Tract 1, Benton County, Oregon",553,439,114,553,70,483,553,0,11,21,27,34,57,0,16,57,43,108,90,59,14,0,16,41,003,000100,3,410030001003
"Block Group 3, Census Tract 47, Lane County, Oregon",458,391,67,458,94,364,458,16,41,8,14,35,0,23,15,28,58,0,22,80,44,19,55,41,039,004700,3,410390047003
"Block Group 4, Census Tract 47, Lane County, Oregon",589,508,81,589,181,408,589,25,30,44,19,37,19,24,27,25,101,94,72,11,12,18,31,41,039,004700,4,410390047004
"Block Group 1, Census Tract 47, Lane County, Oregon",314,277,37,314,46,268,314,19,47,6,0,22,34,16,0,24,0,26,57,15,23,18,7,41,039,004700,1,410390047001
"Block Group 3, Census Tract 50, Lane County, Oregon",530,450,80,530,89,441,530,45,46,0,18,14,44,0,0,13,32,97,124,56,22,19,0,41,039,005000,3,410390050003
"Block Group 1, Census Tract 50, Lane County, Oregon",464,397,67,464,83,381,464,0,0,27,19,21,28,0,43,0,43,58,83,22,53,50,17,41,039,005000,1,410390050001
"Block Group 4, Census Tract 44.03, Lane County, Oregon",592,452,140,592,130,462,592,0,0,72,70,9,49,55,20,22,21,150,92,6,11,15,0,41,039,004403,4,410390044034
"Block Group 1, Census Tract 44.03, Lane County, Oregon",471,402,69,471,145,326,471,28,62,17,38,58,39,36,0,40,0,0,47,18,0,88,0,41,039,004403,1,410390044031
"Block Group 2, Census Tract 44.03, Lane County, Oregon",918,716,202,918,397,521,918,125,146,103,26,32,105,15,74,40,24,124,71,13,10,10,0,41,039,004403,2,410390044032
"Block Group 1, Census Tract 48, Lane County, Oregon",921,824,97,921,208,713,921,423,86,56,25,65,25,0,0,59,36,22,22,0,14,58,30,41,039,004800,1,410390048001
"Block Group 3, Census Tract 48, Lane County, Oregon",630,604,26,630,176,454,630,89,14,122,38,59,54,92,0,64,38,15,0,0,45,0,0,41,039,004800,3,410390048003
"Block Group 1, Census Tract 9.03, Lane County, Oregon",231,131,100,231,28,203,231,48,0,6,25,0,0,0,4,0,52,0,0,5,8,57,26,41,039,000903,1,410390009031
"Block Group 3, Census Tract 9.03, Lane County, Oregon",633,509,124,633,190,443,633,21,26,108,25,41,30,67,3,16,102,27,37,82,16,17,15,41,039,000903,3,410390009033
"Block Group 2, Census Tract 13.02, Lane County, Oregon",807,607,200,807,213,594,807,21,37,70,47,93,53,62,66,23,45,100,122,26,25,10,7,41,039,001302,2,410390013022
"Block Group 1, Census Tract 214, Clackamas County, Oregon",1260,970,290,1260,140,1120,1260,28,0,14,25,16,43,46,36,14,93,82,180,334,93,115,141,41,005,021400,1,410050214001
"Block Group 1, Census Tract 220, Clackamas County, Oregon",685,514,171,685,63,622,685,14,36,0,17,20,18,0,18,0,74,53,164,87,102,65,17,41,005,022000,1,410050220001
"Block Group 2, Census Tract 220, Clackamas County, Oregon",930,641,289,930,88,842,930,53,0,44,28,30,55,0,34,0,80,56,152,153,92,67,86,41,005,022000,2,410050220002
"Block Group 1, Census Tract 231, Clackamas County, Oregon",893,603,290,893,62,831,893,56,10,12,0,16,21,54,0,28,81,98,127,50,77,181,82,41,005,023100,1,410050231001
"Block Group 2, Census Tract 231, Clackamas County, Oregon",566,473,93,566,28,538,566,36,0,0,0,14,14,13,114,38,26,29,123,35,28,70,26,41,005,023100,2,410050231002
"Block Group 3, Census Tract 231, Clackamas County, Oregon",912,746,166,912,22,890,912,17,25,14,0,14,29,97,0,97,45,66,125,99,53,131,100,41,005,023100,3,410050231003
"Block Group 2, Census Tract 233, Clackamas County, Oregon",528,392,136,528,27,501,528,0,11,0,18,9,0,18,0,8,73,79,56,88,49,71,48,41,005,023300,2,410050233002
"Block Group 1, Census Tract 233, Clackamas County, Oregon",817,690,127,817,26,791,817,0,28,36,17,29,38,10,13,48,11,49,41,163,160,97,77,41,005,023300,1,410050233001
"Block Group 3, Census Tract 233, Clackamas County, Oregon",512,408,104,512,27,485,512,30,13,9,10,9,9,16,0,12,92,32,86,69,41,46,38,41,005,023300,3,410050233003
"Block Group 1, Census Tract 3607.02, Josephine County, Oregon",1506,904,602,1506,289,1217,1506,97,129,214,104,64,17,56,99,105,234,96,193,0,34,36,28,41,033,360702,1,410333607021
"Block Group 2, Census Tract 3607.02, Josephine County, Oregon",366,224,142,366,131,235,366,105,0,0,0,50,16,0,32,0,31,17,51,54,0,10,0,41,033,360702,2,410333607022
"Block Group 3, Census Tract 3607.02, Josephine County, Oregon",877,654,223,877,242,635,877,46,14,77,11,44,99,34,31,34,180,130,109,14,25,29,0,41,033,360702,3,410333607023
"Block Group 3, Census Tract 3610, Josephine County, Oregon",548,348,200,548,30,518,548,47,0,10,12,9,10,11,48,0,25,119,119,85,24,29,0,41,033,361000,3,410333610003
"Block Group 4, Census Tract 3610, Josephine County, Oregon",543,419,124,543,157,386,543,33,59,48,25,13,12,8,9,0,74,99,9,59,15,32,48,41,033,361000,4,410333610004
"Block Group 2, Census Tract 3610, Josephine County, Oregon",528,364,164,528,90,438,528,9,11,40,19,32,49,40,56,23,46,41,82,22,29,15,14,41,033,361000,2,410333610002
"Block Group 1, Census Tract 3616, Josephine County, Oregon",515,184,331,515,278,237,515,158,68,89,44,37,6,0,12,58,14,10,19,0,0,0,0,41,033,361600,1,410333616001
"Block Group 7, Census Tract 3616, Josephine County, Oregon",591,321,270,591,261,330,591,108,0,120,128,0,0,63,0,90,18,0,52,0,0,0,12,41,033,361600,7,410333616007
"Block Group 5, Census Tract 3616, Josephine County, Oregon",222,125,97,222,16,206,222,0,16,32,17,15,0,0,37,1,17,0,78,0,9,0,0,41,033,361600,5,410333616005
"Block Group 2, Census Tract 3616, Josephine County, Oregon",700,377,323,700,328,372,700,110,75,25,74,55,69,17,78,0,57,20,27,33,16,37,7,41,033,361600,2,410333616002
"Block Group 3, Census Tract 108, Benton County, Oregon",722,627,95,722,107,615,722,47,37,32,0,31,21,24,0,25,130,118,154,37,16,26,24,41,003,010800,3,410030108003
"Block Group 1, Census Tract 108, Benton County, Oregon",278,210,68,278,124,154,278,69,12,0,25,0,25,12,12,17,0,20,29,13,13,21,10,41,003,010800,1,410030108001
"Block Group 2, Census Tract 108, Benton County, Oregon",391,327,64,391,58,333,391,20,0,9,19,37,0,11,24,12,23,48,67,57,23,31,10,41,003,010800,2,410030108002
"Block Group 4, Census Tract 106, Benton County, Oregon",59,43,16,59,17,42,59,16,17,0,0,0,0,0,0,0,0,0,0,26,0,0,0,41,003,010600,4,410030106004
"Block Group 3, Census Tract 106, Benton County, Oregon",503,330,173,503,15,488,503,274,56,31,15,14,0,22,0,27,38,13,13,0,0,0,0,41,003,010600,3,410030106003
"Block Group 1, Census Tract 106, Benton County, Oregon",823,631,192,823,160,663,823,56,162,50,73,33,35,0,18,25,39,67,123,11,110,0,21,41,003,010600,1,410030106001
"Block Group 5, Census Tract 104, Marion County, Oregon",316,228,88,316,61,255,316,26,23,11,13,0,0,0,14,29,22,90,60,9,0,19,0,41,047,010400,5,410470104005
"Block Group 1, Census Tract 9602, Harney County, Oregon",444,309,135,444,67,377,444,23,12,39,35,11,18,22,20,28,43,22,68,67,8,18,10,41,025,960200,1,410259602001
"Block Group 4, Census Tract 9601, Harney County, Oregon",677,395,282,677,253,424,677,43,0,36,59,79,81,134,82,0,33,42,51,0,33,4,0,41,025,960100,4,410259601004
"Block Group 3, Census Tract 9601, Harney County, Oregon",489,393,96,489,34,455,489,33,2,10,7,38,71,15,26,9,17,56,94,63,14,14,20,41,025,960100,3,410259601003
"Block Group 5, Census Tract 9601, Harney County, Oregon",290,177,113,290,146,144,290,65,0,34,34,42,0,39,15,0,0,25,0,36,0,0,0,41,025,960100,5,410259601005
"Block Group 2, Census Tract 314.02, Washington County, Oregon",627,590,37,627,55,572,627,20,7,22,0,51,23,23,13,57,53,35,134,69,69,41,10,41,067,031402,2,410670314022
"Block Group 3, Census Tract 19.04, Lane County, Oregon",493,264,229,493,134,359,493,0,81,48,90,79,0,33,71,0,27,28,36,0,0,0,0,41,039,001904,3,410390019043
"Block Group 1, Census Tract 29.03, Lane County, Oregon",535,438,97,535,32,503,535,9,14,18,23,10,7,36,31,18,24,43,125,31,42,54,50,41,039,002903,1,410390029031
"Block Group 2, Census Tract 23.01, Lane County, Oregon",431,339,92,431,76,355,431,9,13,8,15,21,21,35,11,51,32,93,38,46,10,28,0,41,039,002301,2,410390023012
"Block Group 3, Census Tract 45.01, Lane County, Oregon",528,467,61,528,91,437,528,25,32,11,8,23,68,44,32,54,76,71,44,19,7,0,14,41,039,004501,3,410390045013
"Block Group 1, Census Tract 45.01, Lane County, Oregon",483,324,159,483,92,391,483,122,15,8,57,54,31,0,8,10,33,35,17,21,25,22,25,41,039,004501,1,410390045011
"Block Group 4, Census Tract 3.01, Multnomah County, Oregon",513,481,32,513,60,453,513,66,30,0,18,44,44,16,0,0,80,50,17,34,31,60,23,41,051,000301,4,410510003014
"Block Group 1, Census Tract 99.04, Multnomah County, Oregon",571,494,77,571,117,454,571,0,11,10,39,27,22,23,15,20,61,75,89,66,96,17,0,41,051,009904,1,410510099041
"Block Group 3, Census Tract 99.04, Multnomah County, Oregon",385,288,97,385,30,355,385,19,0,0,9,15,0,18,0,24,61,25,64,80,33,30,7,41,051,009904,3,410510099043
"Block Group 2, Census Tract 106, Multnomah County, Oregon",1266,502,764,1266,587,679,1266,334,206,123,37,45,89,24,41,22,15,11,61,43,47,110,58,41,051,010600,2,410510106002
"Block Group 3, Census Tract 106, Multnomah County, Oregon",329,172,157,329,131,198,329,87,69,8,59,36,37,0,0,33,0,0,0,0,0,0,0,41,051,010600,3,410510106003
"Block Group 1, Census Tract 23.03, Multnomah County, Oregon",423,324,99,423,109,314,423,120,0,11,30,0,19,10,21,0,28,39,25,69,0,19,32,41,051,002303,1,410510023031
"Block Group 1, Census Tract 22.03, Multnomah County, Oregon",565,513,52,565,86,479,565,33,16,31,0,11,46,9,0,7,68,77,101,42,46,50,28,41,051,002203,1,410510022031
"Block Group 2, Census Tract 22.03, Multnomah County, Oregon",492,444,48,492,87,405,492,0,29,49,0,23,18,0,44,0,12,48,29,69,9,52,110,41,051,002203,2,410510022032
"Block Group 4, Census Tract 22.03, Multnomah County, Oregon",458,349,109,458,190,268,458,63,32,33,0,45,14,14,12,7,14,27,56,51,27,53,10,41,051,002203,4,410510022034
"Block Group 3, Census Tract 65.01, Multnomah County, Oregon",640,583,57,640,58,582,640,0,0,28,0,0,0,0,0,0,16,13,99,122,42,43,277,41,051,006501,3,410510065013
"Block Group 3, Census Tract 307.02, Yamhill County, Oregon",1140,801,339,1140,387,753,1140,13,104,77,15,34,62,93,116,29,125,102,113,79,58,64,56,41,071,030702,3,410710307023
"Block Group 3, Census Tract 308.01, Yamhill County, Oregon",738,554,184,738,358,380,738,49,43,54,56,54,0,36,58,19,9,19,113,83,105,19,21,41,071,030801,3,410710308013
"Block Group 4, Census Tract 35, Lane County, Oregon",499,360,139,499,71,428,499,15,7,24,0,37,26,13,13,0,73,49,69,82,34,49,8,41,039,003500,4,410390035004
"Block Group 1, Census Tract 24.04, Lane County, Oregon",802,619,183,802,79,723,802,41,32,21,20,36,42,15,16,43,68,119,157,122,19,51,0,41,039,002404,1,410390024041
"Block Group 1, Census Tract 28, Lane County, Oregon",894,729,165,894,261,633,894,54,30,68,35,22,160,44,71,37,85,45,136,93,14,0,0,41,039,002800,1,410390028001
"Block Group 2, Census Tract 16, Lane County, Oregon",478,317,161,478,59,419,478,13,9,12,36,33,37,46,29,16,32,68,63,44,25,12,3,41,039,001600,2,410390016002
"Block Group 3, Census Tract 16, Lane County, Oregon",411,272,139,411,35,376,411,20,6,20,3,20,29,12,20,16,52,18,62,36,6,61,30,41,039,001600,3,410390016003
"Block Group 1, Census Tract 16, Lane County, Oregon",228,106,122,228,53,175,228,20,0,53,9,19,0,17,22,0,0,27,39,0,21,0,1,41,039,001600,1,410390016001
"Block Group 4, Census Tract 16, Lane County, Oregon",381,245,136,381,41,340,381,28,0,0,14,4,28,40,0,39,19,5,91,41,16,30,26,41,039,001600,4,410390016004
"Block Group 1, Census Tract 21.01, Lane County, Oregon",483,290,193,483,37,446,483,0,8,26,20,1,44,36,55,46,11,36,91,67,2,4,36,41,039,002101,1,410390021011
"Block Group 3, Census Tract 99.03, Multnomah County, Oregon",763,624,139,763,28,735,763,0,0,14,17,10,0,13,0,28,116,47,121,80,100,82,135,41,051,009903,3,410510099033
"Block Group 2, Census Tract 302, Washington County, Oregon",529,434,95,529,16,513,529,15,18,0,0,0,0,0,71,0,0,16,104,86,19,36,164,41,067,030200,2,410670302002
"Block Group 3, Census Tract 302, Washington County, Oregon",922,841,81,922,58,864,922,5,0,19,0,15,0,18,27,19,70,210,91,89,57,46,256,41,067,030200,3,410670302003
"Block Group 4, Census Tract 308.01, Washington County, Oregon",724,628,96,724,189,535,724,36,26,71,16,0,215,11,18,18,45,98,61,0,74,35,0,41,067,030801,4,410670308014
"Block Group 3, Census Tract 308.01, Washington County, Oregon",758,650,108,758,89,669,758,112,0,0,39,53,32,0,14,42,95,95,96,122,29,14,15,41,067,030801,3,410670308013
"Block Group 2, Census Tract 316.11, Washington County, Oregon",1254,1105,149,1254,147,1107,1254,29,13,17,16,17,19,26,27,62,98,77,375,192,45,96,145,41,067,031611,2,410670316112
"Block Group 3, Census Tract 316.11, Washington County, Oregon",572,544,28,572,18,554,572,13,0,0,0,15,0,11,16,44,17,104,76,64,80,94,38,41,067,031611,3,410670316113
"Block Group 6, Census Tract 17.01, Multnomah County, Oregon",371,332,39,371,74,297,371,0,13,0,0,0,0,20,0,0,26,76,48,48,20,83,37,41,051,001701,6,410510017016
"Block Group 1, Census Tract 9707, Columbia County, Oregon",383,275,108,383,98,285,383,9,12,40,9,40,10,29,39,23,15,31,43,16,34,0,33,41,009,970700,1,410099707001
"Block Group 4, Census Tract 9707, Columbia County, Oregon",607,500,107,607,122,485,607,34,37,0,8,17,43,46,36,58,18,111,115,84,0,0,0,41,009,970700,4,410099707004
"Block Group 3, Census Tract 9707, Columbia County, Oregon",399,341,58,399,100,299,399,18,71,25,0,30,29,11,28,0,14,45,54,54,20,0,0,41,009,970700,3,410099707003
"Block Group 1, Census Tract 9710, Columbia County, Oregon",623,518,105,623,162,461,623,20,32,19,9,59,33,90,0,34,63,31,16,58,107,32,20,41,009,971000,1,410099710001
"Block Group 2, Census Tract 9710, Columbia County, Oregon",725,516,209,725,79,646,725,9,12,8,56,51,10,8,46,0,39,39,173,109,24,62,79,41,009,971000,2,410099710002
"Block Group 3, Census Tract 9710, Columbia County, Oregon",559,450,109,559,34,525,559,9,9,30,10,30,12,0,19,0,11,59,55,139,59,41,76,41,009,971000,3,410099710003
"Block Group 3, Census Tract 9705, Columbia County, Oregon",380,293,87,380,45,335,380,0,0,0,58,16,0,0,20,15,0,39,34,62,45,78,13,41,009,970500,3,410099705003
"Block Group 4, Census Tract 9705, Columbia County, Oregon",326,206,120,326,140,186,326,0,62,0,0,15,0,0,36,0,77,11,36,17,19,36,17,41,009,970500,4,410099705004
"Block Group 1, Census Tract 9705, Columbia County, Oregon",1337,1026,311,1337,187,1150,1337,42,26,21,48,41,98,51,51,44,110,206,203,156,63,70,107,41,009,970500,1,410099705001
"Block Group 2, Census Tract 9705, Columbia County, Oregon",535,457,78,535,54,481,535,0,0,0,0,59,0,18,16,0,16,51,105,129,93,32,16,41,009,970500,2,410099705002
"Block Group 2, Census Tract 9711, Columbia County, Oregon",470,302,168,470,56,414,470,26,27,2,11,27,12,16,8,59,27,23,55,98,45,16,18,41,009,971100,2,410099711002
"Block Group 3, Census Tract 9711, Columbia County, Oregon",504,352,152,504,94,410,504,9,8,25,37,24,15,30,23,37,48,91,25,106,7,15,4,41,009,971100,3,410099711003
"Block Group 1, Census Tract 9711, Columbia County, Oregon",359,268,91,359,105,254,359,17,22,10,29,15,3,6,3,21,8,61,67,31,29,37,0,41,009,971100,1,410099711001
"Block Group 1, Census Tract 9706, Columbia County, Oregon",723,569,154,723,82,641,723,16,0,0,0,13,42,55,32,33,142,49,81,136,55,54,15,41,009,970600,1,410099706001
"Block Group 3, Census Tract 9706, Columbia County, Oregon",397,195,202,397,28,369,397,13,0,0,30,0,14,29,28,14,53,28,69,31,14,74,0,41,009,970600,3,410099706003
"Block Group 2, Census Tract 9709, Columbia County, Oregon",409,322,87,409,89,320,409,14,0,0,0,0,76,0,13,10,9,111,17,26,42,42,49,41,009,970900,2,410099709002
"Block Group 1, Census Tract 9709, Columbia County, Oregon",425,314,111,425,24,401,425,34,12,0,13,11,0,12,0,0,15,57,104,50,33,53,31,41,009,970900,1,410099709001
"Block Group 1, Census Tract 9504, Crook County, Oregon",1585,962,623,1585,244,1341,1585,76,24,88,103,98,92,70,47,99,201,270,190,149,16,30,32,41,013,950400,1,410139504001
"Block Group 2, Census Tract 9504, Crook County, Oregon",231,205,26,231,52,179,231,34,0,19,8,9,19,39,0,0,58,0,14,15,16,0,0,41,013,950400,2,410139504002
"Block Group 2, Census Tract 53, Lane County, Oregon",718,571,147,718,78,640,718,27,0,19,7,0,14,57,13,40,52,84,104,122,43,34,102,41,039,005300,2,410390053002
"Block Group 1, Census Tract 53, Lane County, Oregon",316,249,67,316,45,271,316,0,0,6,9,10,33,33,0,11,16,65,31,29,48,15,10,41,039,005300,1,410390053001
"Block Group 3, Census Tract 11.01, Lane County, Oregon",1003,713,290,1003,150,853,1003,0,38,36,28,16,53,38,23,72,64,165,161,146,43,66,54,41,039,001101,3,410390011013
"Block Group 1, Census Tract 11.01, Lane County, Oregon",668,539,129,668,51,617,668,28,0,0,27,13,0,13,18,0,57,195,48,27,83,41,118,41,039,001101,1,410390011011
"Block Group 3, Census Tract 11.02, Lane County, Oregon",500,333,167,500,76,424,500,48,24,31,9,32,25,38,13,26,46,54,51,43,26,5,29,41,039,001102,3,410390011023
"Block Group 1, Census Tract 11.02, Lane County, Oregon",326,247,79,326,22,304,326,0,0,23,0,50,8,15,9,11,0,7,30,74,36,47,16,41,039,001102,1,410390011021
"Block Group 2, Census Tract 14, Lane County, Oregon",340,201,139,340,86,254,340,13,37,15,18,22,47,18,17,7,38,23,29,10,34,12,0,41,039,001400,2,410390014002
"Block Group 2, Census Tract 3608, Josephine County, Oregon",460,228,232,460,104,356,460,0,40,0,74,19,0,38,40,51,52,57,38,17,0,17,17,41,033,360800,2,410333608002
"Block Group 3, Census Tract 3608, Josephine County, Oregon",1114,717,397,1114,177,937,1114,90,84,34,0,18,107,13,79,16,119,170,108,152,72,25,27,41,033,360800,3,410333608003
"Block Group 2, Census Tract 3605, Josephine County, Oregon",374,295,79,374,116,258,374,35,27,33,31,0,0,17,15,75,47,13,36,14,0,15,16,41,033,360500,2,410333605002
"Block Group 4, Census Tract 3605, Josephine County, Oregon",716,552,164,716,234,482,716,68,67,34,58,0,18,36,0,35,80,133,84,18,32,0,53,41,033,360500,4,410333605004
"Block Group 1, Census Tract 3615, Josephine County, Oregon",1072,727,345,1072,113,959,1072,75,46,0,107,57,96,51,16,90,71,170,144,15,40,23,71,41,033,361500,1,410333615001
"Block Group 1, Census Tract 9702, Klamath County, Oregon",504,347,157,504,95,409,504,16,102,61,52,0,65,35,35,14,66,42,0,0,0,0,16,41,035,970200,1,410359702001
"Block Group 2, Census Tract 9702, Klamath County, Oregon",466,152,314,466,118,348,466,0,34,108,21,112,0,0,18,25,50,0,15,0,0,26,57,41,035,970200,2,410359702002
"Block Group 4, Census Tract 9702, Klamath County, Oregon",456,343,113,456,99,357,456,27,20,11,43,19,42,18,11,9,40,56,134,6,0,4,16,41,035,970200,4,410359702004
"Block Group 1, Census Tract 105.02, Marion County, Oregon",1187,874,313,1187,181,1006,1187,44,36,57,37,56,31,90,108,39,99,149,221,124,16,38,42,41,047,010502,1,410470105021
"Block Group 3, Census Tract 105.02, Marion County, Oregon",216,140,76,216,22,194,216,34,0,15,14,0,0,0,0,0,0,49,29,15,11,49,0,41,047,010502,3,410470105023
"Block Group 3, Census Tract 17.02, Marion County, Oregon",661,614,47,661,260,401,661,15,85,44,103,6,23,73,0,59,27,70,53,59,10,34,0,41,047,001702,3,410470017023
"Block Group 1, Census Tract 17.02, Marion County, Oregon",474,403,71,474,119,355,474,0,8,8,35,20,9,31,0,8,22,102,88,56,33,39,15,41,047,001702,1,410470017021
"Block Group 3, Census Tract 6, Marion County, Oregon",712,522,190,712,236,476,712,96,70,13,15,13,94,47,15,67,28,54,70,67,63,0,0,41,047,000600,3,410470006003
"Block Group 1, Census Tract 6, Marion County, Oregon",624,430,194,624,165,459,624,25,62,16,9,11,41,49,82,14,27,79,69,47,33,12,48,41,047,000600,1,410470006001
"Block Group 4, Census Tract 16.04, Marion County, Oregon",797,660,137,797,244,553,797,53,39,27,91,41,129,0,25,0,107,13,150,83,16,23,0,41,047,001604,4,410470016044
"Block Group 1, Census Tract 17.01, Marion County, Oregon",696,578,118,696,381,315,696,84,11,166,60,51,54,18,51,16,28,92,54,0,0,11,0,41,047,001701,1,410470017011
"Block Group 3, Census Tract 17.01, Marion County, Oregon",795,519,276,795,233,562,795,54,12,0,39,217,25,15,23,15,18,101,93,83,56,44,0,41,047,001701,3,410470017013
"Block Group 2, Census Tract 17.03, Marion County, Oregon",533,316,217,533,84,449,533,17,7,18,45,26,52,18,43,27,41,36,35,130,9,29,0,41,047,001703,2,410470017032
"Block Group 3, Census Tract 17.03, Marion County, Oregon",538,445,93,538,115,423,538,8,0,15,9,16,0,28,54,31,84,69,115,60,30,11,8,41,047,001703,3,410470017033
"Block Group 1, Census Tract 24, Marion County, Oregon",569,419,150,569,36,533,569,17,0,16,9,18,23,0,10,8,12,99,92,72,71,48,74,41,047,002400,1,410470024001
"Block Group 4, Census Tract 103.04, Marion County, Oregon",277,235,42,277,75,202,277,31,36,0,0,17,9,0,53,0,0,7,68,0,8,48,0,41,047,010304,4,410470103044
"Block Group 2, Census Tract 103.04, Marion County, Oregon",782,745,37,782,129,653,782,0,0,37,8,0,9,75,40,30,94,132,162,117,17,52,9,41,047,010304,2,410470103042
"Block Group 3, Census Tract 103.04, Marion County, Oregon",259,226,33,259,74,185,259,33,0,0,37,28,0,11,0,0,9,69,21,12,8,20,11,41,047,010304,3,410470103043
"Block Group 1, Census Tract 328, Washington County, Oregon",432,362,70,432,48,384,432,10,5,9,34,9,4,44,21,53,14,38,60,37,22,43,29,41,067,032800,1,410670328001
"Block Group 2, Census Tract 308.03, Washington County, Oregon",576,200,376,576,38,538,576,47,14,15,13,84,56,16,12,30,77,52,60,67,0,24,9,41,067,030803,2,410670308032
"Block Group 3, Census Tract 308.03, Washington County, Oregon",663,407,256,663,8,655,663,19,13,24,40,0,0,13,25,28,40,118,105,69,82,42,45,41,067,030803,3,410670308033
"Block Group 1, Census Tract 308.03, Washington County, Oregon",857,783,74,857,96,761,857,0,69,34,74,59,12,0,0,18,211,106,86,76,42,28,42,41,067,030803,1,410670308031
"Block Group 2, Census Tract 303, Washington County, Oregon",428,313,115,428,40,388,428,0,0,8,38,9,45,0,21,15,20,29,24,17,32,19,151,41,067,030300,2,410670303002
"Block Group 4, Census Tract 303, Washington County, Oregon",572,515,57,572,0,572,572,0,11,11,0,19,11,0,26,62,59,7,81,44,47,63,131,41,067,030300,4,410670303004
"Block Group 1, Census Tract 303, Washington County, Oregon",560,457,103,560,9,551,560,30,0,9,9,20,22,54,0,0,15,41,0,61,60,46,193,41,067,030300,1,410670303001
"Block Group 3, Census Tract 303, Washington County, Oregon",303,231,72,303,0,303,303,9,14,0,0,0,0,12,25,0,0,44,33,34,0,53,79,41,067,030300,3,410670303003
"Block Group 5, Census Tract 310.03, Washington County, Oregon",706,629,77,706,28,678,706,16,16,0,66,45,12,11,13,0,44,0,183,82,33,154,31,41,067,031003,5,410670310035
"Block Group 4, Census Tract 310.03, Washington County, Oregon",1094,937,157,1094,76,1018,1094,13,10,12,0,17,19,53,15,45,99,189,76,192,142,92,120,41,067,031003,4,410670310034
"Block Group 1, Census Tract 310.03, Washington County, Oregon",591,528,63,591,94,497,591,26,14,16,17,79,63,12,0,0,30,45,170,54,0,65,0,41,067,031003,1,410670310031
"Block Group 2, Census Tract 9701, Morrow County, Oregon",569,459,110,569,170,399,569,14,34,5,0,78,0,35,26,27,0,84,101,99,55,11,0,41,049,970100,2,410499701002
"Block Group 3, Census Tract 9701, Morrow County, Oregon",337,281,56,337,134,203,337,6,27,33,48,13,35,7,0,37,5,40,11,24,21,24,6,41,049,970100,3,410499701003
"Block Group 5, Census Tract 9701, Morrow County, Oregon",570,352,218,570,62,508,570,60,0,70,7,20,53,22,0,32,105,31,55,51,37,0,27,41,049,970100,5,410499701005
"Block Group 1, Census Tract 9512, Clatsop County, Oregon",306,174,132,306,60,246,306,9,44,10,7,10,43,0,11,10,22,62,49,9,20,0,0,41,007,951200,1,410079512001
"Block Group 2, Census Tract 105.01, Marion County, Oregon",299,270,29,299,60,239,299,0,0,0,0,34,0,0,0,20,15,80,17,84,31,18,0,41,047,010501,2,410470105012
"Block Group 1, Census Tract 4, Marion County, Oregon",807,647,160,807,266,541,807,45,39,59,20,63,61,26,40,72,87,41,82,98,41,15,18,41,047,000400,1,410470004001
"Block Group 2, Census Tract 4, Marion County, Oregon",590,527,63,590,302,288,590,36,19,91,30,18,46,10,86,33,50,33,62,76,0,0,0,41,047,000400,2,410470004002
"Block Group 2, Census Tract 10, Marion County, Oregon",624,505,119,624,262,362,624,45,88,20,45,14,76,8,57,65,16,57,84,20,15,14,0,41,047,001000,2,410470010002
"Block Group 3, Census Tract 10, Marion County, Oregon",641,415,226,641,133,508,641,35,7,51,65,19,56,42,23,97,26,63,103,35,6,0,13,41,047,001000,3,410470010003
"Block Group 1, Census Tract 17, Lane County, Oregon",713,385,328,713,262,451,713,52,13,106,60,105,0,14,14,41,61,106,97,31,0,13,0,41,039,001700,1,410390017001
"Block Group 3, Census Tract 17, Lane County, Oregon",444,256,188,444,41,403,444,15,58,16,30,28,14,32,15,16,0,41,28,65,28,42,16,41,039,001700,3,410390017003
"Block Group 4, Census Tract 17, Lane County, Oregon",648,502,146,648,31,617,648,0,0,33,16,0,70,0,14,15,77,15,161,44,79,101,23,41,039,001700,4,410390017004
"Block Group 1, Census Tract 24.01, Lane County, Oregon",326,282,44,326,29,297,326,8,0,0,17,17,0,17,10,11,10,23,7,62,44,34,66,41,039,002401,1,410390024011
"Block Group 1, Census Tract 29.02, Lane County, Oregon",1123,637,486,1123,220,903,1123,142,29,100,56,26,61,53,80,21,74,181,93,68,87,41,11,41,039,002902,1,410390029021
"Block Group 2, Census Tract 30, Lane County, Oregon",1110,879,231,1110,125,985,1110,94,90,128,37,84,40,41,86,11,32,86,36,121,82,75,67,41,039,003000,2,410390030002
"Block Group 3, Census Tract 310.03, Washington County, Oregon",264,200,64,264,14,250,264,0,0,16,0,34,0,0,0,9,0,49,58,21,15,32,30,41,067,031003,3,410670310033
"Block Group 2, Census Tract 310.06, Washington County, Oregon",355,298,57,355,35,320,355,0,0,15,0,0,32,30,0,56,0,29,32,38,64,45,14,41,067,031006,2,410670310062
"Block Group 1, Census Tract 310.06, Washington County, Oregon",1002,820,182,1002,22,980,1002,89,0,41,62,16,21,22,30,0,250,97,170,70,50,70,14,41,067,031006,1,410670310061
"Block Group 4, Census Tract 310.06, Washington County, Oregon",1048,1000,48,1048,125,923,1048,13,43,17,90,0,173,124,69,17,188,153,84,62,15,0,0,41,067,031006,4,410670310064
"Block Group 2, Census Tract 317.06, Washington County, Oregon",402,329,73,402,146,256,402,0,18,56,19,4,0,39,35,5,45,10,89,45,22,15,0,41,067,031706,2,410670317062
"Block Group 3, Census Tract 317.06, Washington County, Oregon",471,413,58,471,60,411,471,40,28,0,0,25,21,7,0,28,11,7,130,33,72,69,0,41,067,031706,3,410670317063
"Block Group 1, Census Tract 316.10, Washington County, Oregon",327,274,53,327,0,327,327,12,11,0,0,0,0,0,17,0,0,50,65,65,29,39,39,41,067,031610,1,410670316101
"Block Group 4, Census Tract 316.10, Washington County, Oregon",1140,973,167,1140,121,1019,1140,15,14,25,46,50,97,13,38,42,89,152,214,66,85,61,133,41,067,031610,4,410670316104
"Block Group 3, Census Tract 316.10, Washington County, Oregon",237,208,29,237,50,187,237,8,0,0,14,15,12,0,32,16,54,13,0,73,0,0,0,41,067,031610,3,410670316103
"Block Group 3, Census Tract 320.01, Washington County, Oregon",377,303,74,377,14,363,377,5,2,4,16,5,0,10,2,7,0,30,52,33,40,70,101,41,067,032001,3,410670320013
"Block Group 3, Census Tract 9512, Clatsop County, Oregon",458,364,94,458,130,328,458,35,8,37,14,10,7,43,35,23,62,13,62,29,43,24,13,41,007,951200,3,410079512003
"Block Group 1, Census Tract 9513, Clatsop County, Oregon",595,401,194,595,91,504,595,4,13,26,52,41,27,28,36,21,54,65,93,83,23,11,18,41,007,951300,1,410079513001
"Block Group 1, Census Tract 9505, Clatsop County, Oregon",506,355,151,506,98,408,506,0,9,11,28,20,29,32,41,9,72,48,97,50,15,35,10,41,007,950500,1,410079505001
"Block Group 2, Census Tract 9502, Clatsop County, Oregon",372,257,115,372,95,277,372,31,23,31,22,39,33,21,8,0,27,42,28,33,10,6,18,41,007,950200,2,410079502002
"Block Group 1, Census Tract 9502, Clatsop County, Oregon",562,319,243,562,43,519,562,48,17,0,28,58,41,60,29,0,34,67,47,39,19,48,27,41,007,950200,1,410079502001
"Block Group 3, Census Tract 9502, Clatsop County, Oregon",553,459,94,553,66,487,553,25,17,24,17,0,39,30,0,46,91,26,76,114,26,0,22,41,007,950200,3,410079502003
"Block Group 1, Census Tract 9503, Clatsop County, Oregon",343,214,129,343,45,298,343,29,12,41,11,14,24,13,20,50,32,35,25,0,11,26,0,41,007,950300,1,410079503001
"Block Group 4, Census Tract 9503, Clatsop County, Oregon",277,193,84,277,25,252,277,17,15,9,0,17,10,10,23,11,8,15,54,32,41,15,0,41,007,950300,4,410079503004
"Block Group 1, Census Tract 9506, Clatsop County, Oregon",483,379,104,483,47,436,483,0,17,27,0,21,31,23,33,32,79,8,85,87,9,20,11,41,007,950600,1,410079506001
"Block Group 3, Census Tract 9506, Clatsop County, Oregon",206,149,57,206,37,169,206,10,8,0,0,10,21,11,0,37,0,48,5,27,0,29,0,41,007,950600,3,410079506003
"Block Group 1, Census Tract 9509, Clatsop County, Oregon",378,272,106,378,123,255,378,0,0,0,16,0,0,49,0,33,17,65,114,44,0,0,40,41,007,950900,1,410079509001
"Block Group 2, Census Tract 9509, Clatsop County, Oregon",414,271,143,414,22,392,414,0,0,35,0,66,31,21,43,50,48,22,45,23,30,0,0,41,007,950900,2,410079509002
"Block Group 3, Census Tract 9509, Clatsop County, Oregon",411,275,136,411,107,304,411,70,28,49,37,75,16,0,37,31,18,0,50,0,0,0,0,41,007,950900,3,410079509003
"Block Group 4, Census Tract 9509, Clatsop County, Oregon",211,176,35,211,123,88,211,0,21,41,0,33,0,11,0,35,0,18,0,17,35,0,0,41,007,950900,4,410079509004
"Block Group 2, Census Tract 5.02, Multnomah County, Oregon",271,184,87,271,60,211,271,10,28,14,10,10,10,0,9,0,11,49,83,14,23,0,0,41,051,000502,2,410510005022
"Block Group 5, Census Tract 5.02, Multnomah County, Oregon",497,426,71,497,95,402,497,41,34,20,12,21,0,49,15,21,10,44,53,122,20,13,22,41,051,000502,5,410510005025
"Block Group 1, Census Tract 5.02, Multnomah County, Oregon",360,336,24,360,61,299,360,22,0,14,0,0,8,0,26,22,20,40,107,77,9,15,0,41,051,000502,1,410510005021
"Block Group 3, Census Tract 8.02, Multnomah County, Oregon",558,484,74,558,72,486,558,15,14,0,14,14,42,50,39,11,54,41,54,127,75,0,8,41,051,000802,3,410510008023
"Block Group 4, Census Tract 8.02, Multnomah County, Oregon",759,686,73,759,196,563,759,68,24,17,59,40,0,31,41,0,71,95,196,35,37,26,19,41,051,000802,4,410510008024
"Block Group 2, Census Tract 8.02, Multnomah County, Oregon",358,314,44,358,58,300,358,0,0,44,0,11,20,0,0,36,80,29,51,43,9,35,0,41,051,000802,2,410510008022
"Block Group 4, Census Tract 10, Multnomah County, Oregon",413,374,39,413,32,381,413,0,17,0,32,0,0,0,13,0,17,33,102,103,48,32,16,41,051,001000,4,410510010004
"Block Group 3, Census Tract 10, Multnomah County, Oregon",564,512,52,564,63,501,564,0,38,0,0,14,32,15,22,13,48,106,67,0,53,126,30,41,051,001000,3,410510010003
"Block Group 2, Census Tract 10, Multnomah County, Oregon",610,542,68,610,95,515,610,34,56,25,0,0,47,0,16,0,26,66,44,83,84,63,66,41,051,001000,2,410510010002
"Block Group 1, Census Tract 11.01, Multnomah County, Oregon",675,489,186,675,264,411,675,186,90,59,0,31,72,19,21,0,28,45,37,59,9,19,0,41,051,001101,1,410510011011
"Block Group 2, Census Tract 12.01, Multnomah County, Oregon",727,611,116,727,59,668,727,50,14,15,53,15,53,39,24,0,37,73,134,16,71,36,97,41,051,001201,2,410510012012
"Block Group 4, Census Tract 12.01, Multnomah County, Oregon",1127,1043,84,1127,178,949,1127,140,77,0,15,70,59,32,0,67,33,118,252,20,57,73,114,41,051,001201,4,410510012014
"Block Group 2, Census Tract 230.01, Clackamas County, Oregon",439,317,122,439,35,404,439,5,31,0,0,40,13,0,51,6,54,43,42,54,25,17,58,41,005,023001,2,410050230012
"Block Group 1, Census Tract 234.03, Clackamas County, Oregon",1994,1679,315,1994,359,1635,1994,42,23,81,49,52,159,54,89,133,113,229,408,207,81,141,133,41,005,023403,1,410050234031
"Block Group 3, Census Tract 234.04, Clackamas County, Oregon",464,241,223,464,45,419,464,32,16,71,31,0,34,0,14,30,32,63,61,0,13,17,50,41,005,023404,3,410050234043
"Block Group 4, Census Tract 234.04, Clackamas County, Oregon",496,353,143,496,65,431,496,0,15,65,0,0,0,0,32,0,28,43,156,52,41,15,49,41,005,023404,4,410050234044
"Block Group 1, Census Tract 234.04, Clackamas County, Oregon",584,508,76,584,0,584,584,16,0,27,0,17,15,0,0,0,31,33,181,176,31,31,26,41,005,023404,1,410050234041
"Block Group 2, Census Tract 234.04, Clackamas County, Oregon",952,768,184,952,300,652,952,74,17,17,57,31,64,61,0,0,97,186,129,135,21,48,15,41,005,023404,2,410050234042
"Block Group 2, Census Tract 239.02, Clackamas County, Oregon",529,449,80,529,169,360,529,18,34,11,19,8,42,39,34,19,41,69,76,21,58,40,0,41,005,023902,2,410050239022
"Block Group 1, Census Tract 4.05, Jackson County, Oregon",720,554,166,720,322,398,720,91,69,80,51,14,31,39,31,31,37,56,82,40,27,32,9,41,029,000405,1,410290004051
"Block Group 4, Census Tract 10.01, Jackson County, Oregon",715,373,342,715,56,659,715,27,35,14,42,95,109,15,15,55,88,136,53,23,0,8,0,41,029,001001,4,410290010014
"Block Group 3, Census Tract 321.03, Washington County, Oregon",1309,1136,173,1309,0,1309,1309,14,30,17,44,42,45,13,11,48,88,103,201,183,44,251,175,41,067,032103,3,410670321033
"Block Group 3, Census Tract 304.01, Washington County, Oregon",665,570,95,665,86,579,665,0,26,25,49,27,13,45,52,61,107,90,64,53,27,11,15,41,067,030401,3,410670304013
"Block Group 3, Census Tract 304.02, Washington County, Oregon",751,713,38,751,79,672,751,0,25,15,23,15,18,38,0,9,41,99,117,0,100,69,182,41,067,030402,3,410670304023
"Block Group 1, Census Tract 10, Marion County, Oregon",349,300,49,349,126,223,349,11,20,0,27,71,53,7,16,20,25,17,82,0,0,0,0,41,047,001000,1,410470010001
"Block Group 1, Census Tract 103.03, Marion County, Oregon",646,569,77,646,132,514,646,39,14,3,28,24,40,8,27,23,73,68,130,59,33,64,13,41,047,010303,1,410470103031
"Block Group 2, Census Tract 103.03, Marion County, Oregon",583,458,125,583,124,459,583,37,11,9,26,10,51,29,38,7,46,77,84,47,41,47,23,41,047,010303,2,410470103032
"Block Group 1, Census Tract 211, Clackamas County, Oregon",408,335,73,408,120,288,408,14,67,32,32,0,19,22,0,19,55,0,35,53,41,19,0,41,005,021100,1,410050211001
"Block Group 3, Census Tract 211, Clackamas County, Oregon",558,472,86,558,17,541,558,0,0,0,15,16,15,0,12,49,35,105,164,37,68,20,22,41,005,021100,3,410050211003
"Block Group 2, Census Tract 211, Clackamas County, Oregon",582,488,94,582,27,555,582,13,18,13,19,0,19,48,46,26,50,14,108,116,57,21,14,41,005,021100,2,410050211002
"Block Group 1, Census Tract 202.03, Polk County, Oregon",511,390,121,511,147,364,511,31,21,27,36,38,0,65,20,11,54,79,65,27,10,27,0,41,053,020203,1,410530202031
"Block Group 3, Census Tract 202.03, Polk County, Oregon",331,254,77,331,94,237,331,11,10,60,0,10,83,18,19,0,27,13,53,27,0,0,0,41,053,020203,3,410530202033
"Block Group 2, Census Tract 202.03, Polk County, Oregon",234,183,51,234,111,123,234,32,0,8,83,12,9,8,21,11,9,19,7,10,0,5,0,41,053,020203,2,410530202032
"Block Group 3, Census Tract 203.02, Polk County, Oregon",998,854,144,998,205,793,998,23,13,42,12,28,54,97,81,12,126,211,65,84,96,54,0,41,053,020302,3,410530203023
"Block Group 4, Census Tract 203.02, Polk County, Oregon",401,355,46,401,134,267,401,0,0,13,79,12,27,17,0,80,24,49,39,0,0,61,0,41,053,020302,4,410530203024
"Block Group 2, Census Tract 203.02, Polk County, Oregon",259,157,102,259,29,230,259,14,14,0,27,0,27,16,17,0,0,0,57,54,0,15,18,41,053,020302,2,410530203022
"Block Group 2, Census Tract 304, Yamhill County, Oregon",782,513,269,782,46,736,782,0,0,6,11,17,16,19,104,14,98,97,61,104,69,49,117,41,071,030400,2,410710304002
"Block Group 5, Census Tract 304, Yamhill County, Oregon",870,647,223,870,81,789,870,10,21,14,66,29,6,29,32,14,48,164,168,112,83,62,12,41,071,030400,5,410710304005
"Block Group 1, Census Tract 304, Yamhill County, Oregon",315,240,75,315,17,298,315,0,0,17,16,0,0,13,0,0,52,33,0,31,70,31,52,41,071,030400,1,410710304001
"Block Group 2, Census Tract 307.01, Yamhill County, Oregon",1752,971,781,1752,320,1432,1752,88,59,72,100,70,26,64,86,166,137,128,194,186,251,87,38,41,071,030701,2,410710307012
"Block Group 1, Census Tract 308.01, Yamhill County, Oregon",748,348,400,748,342,406,748,135,75,89,32,144,0,43,66,42,26,10,45,11,0,30,0,41,071,030801,1,410710308011
"Block Group 2, Census Tract 308.01, Yamhill County, Oregon",799,681,118,799,243,556,799,0,22,118,127,62,11,11,21,116,13,20,171,61,19,0,27,41,071,030801,2,410710308012
"Block Group 3, Census Tract 305.02, Yamhill County, Oregon",405,304,101,405,95,310,405,10,34,30,7,59,25,8,38,0,53,28,49,25,10,18,11,41,071,030502,3,410710305023
"Block Group 2, Census Tract 308.02, Yamhill County, Oregon",59,59,0,59,29,30,59,6,7,0,0,22,0,0,0,0,0,0,0,24,0,0,0,41,071,030802,2,410710308022
"Block Group 1, Census Tract 308.02, Yamhill County, Oregon",831,671,160,831,331,500,831,104,44,29,38,60,65,46,39,32,36,49,172,79,10,0,28,41,071,030802,1,410710308021
"Block Group 2, Census Tract 309, Yamhill County, Oregon",662,569,93,662,86,576,662,31,25,12,9,35,44,43,14,12,78,26,68,67,61,91,46,41,071,030900,2,410710309002
"Block Group 3, Census Tract 302.02, Yamhill County, Oregon",999,890,109,999,216,783,999,23,11,65,97,84,94,12,5,47,55,49,275,71,43,35,33,41,071,030202,3,410710302023
"Block Group 1, Census Tract 107.01, Marion County, Oregon",448,295,153,448,47,401,448,0,0,25,15,15,22,16,15,14,25,11,160,98,16,16,0,41,047,010701,1,410470107011
"Block Group 1, Census Tract 15.03, Marion County, Oregon",587,422,165,587,137,450,587,24,47,42,28,54,53,29,0,73,57,23,67,42,38,10,0,41,047,001503,1,410470015031
"Block Group 3, Census Tract 15.03, Marion County, Oregon",482,343,139,482,79,403,482,50,10,49,31,22,21,13,24,15,73,35,69,56,5,4,5,41,047,001503,3,410470015033
"Block Group 1, Census Tract 16.01, Marion County, Oregon",562,444,118,562,189,373,562,22,17,0,106,0,35,17,33,12,62,58,108,0,11,81,0,41,047,001601,1,410470016011
"Block Group 2, Census Tract 16.01, Marion County, Oregon",1015,826,189,1015,192,823,1015,20,26,16,69,58,0,26,0,57,214,182,88,86,81,46,46,41,047,001601,2,410470016012
"Block Group 1, Census Tract 20, Marion County, Oregon",1203,642,561,1203,345,858,1203,127,47,83,95,70,77,16,13,35,47,80,183,154,32,83,61,41,047,002000,1,410470020001
"Block Group 2, Census Tract 20, Marion County, Oregon",805,709,96,805,18,787,805,0,0,0,26,16,66,70,18,27,58,79,157,98,81,39,70,41,047,002000,2,410470020002
"Block Group 1, Census Tract 16.03, Marion County, Oregon",631,477,154,631,70,561,631,20,0,0,27,0,46,49,0,23,43,87,164,80,50,42,0,41,047,001603,1,410470016031
"Block Group 3, Census Tract 204, Polk County, Oregon",317,261,56,317,66,251,317,23,14,3,36,13,10,8,9,0,21,30,89,25,16,9,11,41,053,020400,3,410530204003
"Block Group 1, Census Tract 9706, Union County, Oregon",453,358,95,453,10,443,453,17,0,0,0,30,12,15,10,10,34,65,84,89,28,29,30,41,061,970600,1,410619706001
"Block Group 4, Census Tract 9706, Union County, Oregon",279,217,62,279,46,233,279,12,32,0,8,12,21,14,0,10,0,21,43,59,16,21,10,41,061,970600,4,410619706004
"Block Group 3, Census Tract 306, Linn County, Oregon",474,348,126,474,33,441,474,0,12,0,73,0,2,21,18,27,61,61,22,21,96,32,28,41,043,030600,3,410430306003
"Block Group 4, Census Tract 306, Linn County, Oregon",818,652,166,818,189,629,818,16,57,28,84,30,114,68,126,32,25,138,24,34,42,0,0,41,043,030600,4,410430306004
"Block Group 2, Census Tract 306, Linn County, Oregon",509,431,78,509,69,440,509,26,22,10,0,26,28,24,18,11,52,89,102,76,11,14,0,41,043,030600,2,410430306002
"Block Group 2, Census Tract 38.02, Multnomah County, Oregon",386,293,93,386,32,354,386,11,0,0,0,29,8,7,13,0,32,54,112,32,37,35,16,41,051,003802,2,410510038022
"Block Group 1, Census Tract 38.02, Multnomah County, Oregon",582,546,36,582,40,542,582,26,38,26,0,21,11,0,29,0,86,22,135,64,60,22,42,41,051,003802,1,410510038021
"Block Group 1, Census Tract 87, Multnomah County, Oregon",573,523,50,573,91,482,573,41,0,8,26,12,55,8,19,29,77,57,109,68,9,35,20,41,051,008700,1,410510087001
"Block Group 3, Census Tract 87, Multnomah County, Oregon",542,429,113,542,145,397,542,0,27,18,33,8,0,17,47,60,26,58,117,28,41,40,22,41,051,008700,3,410510087003
"Block Group 2, Census Tract 91.02, Multnomah County, Oregon",676,543,133,676,112,564,676,36,19,19,41,59,26,19,0,18,20,51,158,71,74,65,0,41,051,009102,2,410510091022
"Block Group 1, Census Tract 91.02, Multnomah County, Oregon",394,358,36,394,139,255,394,0,14,0,77,4,25,21,47,46,23,19,37,35,26,20,0,41,051,009102,1,410510091021
"Block Group 1, Census Tract 96.04, Multnomah County, Oregon",873,684,189,873,224,649,873,20,37,42,46,91,83,65,60,68,90,47,92,95,20,17,0,41,051,009604,1,410510096041
"Block Group 2, Census Tract 96.04, Multnomah County, Oregon",976,843,133,976,368,608,976,117,52,81,24,56,43,23,94,79,97,114,103,57,12,24,0,41,051,009604,2,410510096042
"Block Group 2, Census Tract 96.05, Multnomah County, Oregon",570,413,157,570,119,451,570,4,19,0,25,69,30,43,111,14,29,16,83,49,23,25,30,41,051,009605,2,410510096052
"Block Group 1, Census Tract 96.05, Multnomah County, Oregon",914,731,183,914,144,770,914,46,0,67,47,170,52,65,154,33,19,63,76,68,47,0,7,41,051,009605,1,410510096051
"Block Group 2, Census Tract 96.06, Multnomah County, Oregon",897,735,162,897,391,506,897,22,189,65,113,117,79,11,38,7,20,95,27,33,50,12,19,41,051,009606,2,410510096062
"Block Group 1, Census Tract 96.06, Multnomah County, Oregon",1051,817,234,1051,268,783,1051,27,49,40,124,48,52,17,79,114,112,107,177,57,28,11,9,41,051,009606,1,410510096061
"Block Group 3, Census Tract 6, Benton County, Oregon",809,582,227,809,34,775,809,25,0,15,16,33,126,43,65,33,131,34,115,80,22,71,0,41,003,000600,3,410030006003
"Block Group 2, Census Tract 6, Benton County, Oregon",445,325,120,445,24,421,445,27,15,14,96,29,9,44,0,0,16,32,37,18,0,56,52,41,003,000600,2,410030006002
"Block Group 2, Census Tract 103, Benton County, Oregon",364,289,75,364,44,320,364,18,3,2,3,0,7,11,23,11,44,33,93,32,43,41,0,41,003,010300,2,410030103002
"Block Group 1, Census Tract 103, Benton County, Oregon",547,398,149,547,46,501,547,12,0,25,15,17,61,34,7,17,30,43,136,51,37,48,14,41,003,010300,1,410030103001
"Block Group 3, Census Tract 103, Benton County, Oregon",429,324,105,429,89,340,429,45,20,3,31,9,19,11,5,8,49,34,85,30,23,14,43,41,003,010300,3,410030103003
"Block Group 2, Census Tract 102, Benton County, Oregon",461,387,74,461,0,461,461,0,9,0,7,12,11,17,22,0,20,35,54,84,33,73,84,41,003,010200,2,410030102002
"Block Group 3, Census Tract 102, Benton County, Oregon",380,299,81,380,46,334,380,13,22,11,8,19,43,0,25,0,56,48,63,35,16,0,21,41,003,010200,3,410030102003
"Block Group 2, Census Tract 11.01, Benton County, Oregon",582,421,161,582,44,538,582,182,49,116,0,64,53,12,19,13,35,0,19,10,0,0,10,41,003,001101,2,410030011012
"Block Group 2, Census Tract 317.04, Washington County, Oregon",439,338,101,439,41,398,439,17,0,0,0,71,0,21,17,0,16,52,42,147,14,25,17,41,067,031704,2,410670317042
"Block Group 4, Census Tract 317.04, Washington County, Oregon",330,312,18,330,15,315,330,0,0,0,0,0,15,13,18,0,64,19,50,122,14,0,15,41,067,031704,4,410670317044
"Block Group 1, Census Tract 11.01, Benton County, Oregon",374,320,54,374,94,280,374,82,51,9,21,20,29,10,0,11,17,17,93,0,8,6,0,41,003,001101,1,410030011011
"Block Group 5, Census Tract 9702, Columbia County, Oregon",644,423,221,644,83,561,644,17,7,49,42,39,56,31,57,22,47,44,107,49,51,12,14,41,009,970200,5,410099702005
"Block Group 1, Census Tract 9702, Columbia County, Oregon",421,169,252,421,127,294,421,34,96,52,47,31,0,42,13,7,33,12,14,7,13,17,3,41,009,970200,1,410099702001
"Block Group 4, Census Tract 9702, Columbia County, Oregon",530,417,113,530,82,448,530,39,24,10,13,14,39,0,17,42,95,13,45,14,67,53,45,41,009,970200,4,410099702004
"Block Group 3, Census Tract 9702, Columbia County, Oregon",519,323,196,519,78,441,519,0,47,47,27,12,26,0,0,33,97,64,62,0,0,75,29,41,009,970200,3,410099702003
"Block Group 2, Census Tract 9708, Columbia County, Oregon",923,593,330,923,383,540,923,64,36,25,107,103,107,44,48,30,124,47,103,50,15,20,0,41,009,970800,2,410099708002
"Block Group 3, Census Tract 9708, Columbia County, Oregon",1233,958,275,1233,296,937,1233,44,32,46,83,40,22,35,40,32,76,113,309,125,90,95,51,41,009,970800,3,410099708003
"Block Group 3, Census Tract 9703, Columbia County, Oregon",292,232,60,292,49,243,292,0,21,20,0,0,32,0,7,7,17,42,47,71,6,22,0,41,009,970300,3,410099703003
"Block Group 4, Census Tract 9703, Columbia County, Oregon",334,245,89,334,70,264,334,2,0,37,13,9,31,4,21,22,50,54,15,9,38,28,1,41,009,970300,4,410099703004
"Block Group 2, Census Tract 21.02, Lane County, Oregon",965,716,249,965,345,620,965,119,15,46,143,33,45,132,102,43,141,50,41,38,17,0,0,41,039,002102,2,410390021022
"Block Group 2, Census Tract 304.02, Washington County, Oregon",601,301,300,601,61,540,601,58,102,36,56,0,0,13,0,40,38,62,0,71,33,27,65,41,067,030402,2,410670304022
"Block Group 3, Census Tract 306, Washington County, Oregon",441,384,57,441,32,409,441,0,45,0,0,0,0,0,19,28,32,0,101,93,58,19,46,41,067,030600,3,410670306003
"Block Group 4, Census Tract 99.03, Multnomah County, Oregon",425,304,121,425,40,385,425,0,0,0,0,22,0,0,17,17,0,13,74,84,105,93,0,41,051,009903,4,410510099034
"Block Group 3, Census Tract 102, Multnomah County, Oregon",1031,809,222,1031,73,958,1031,26,0,0,0,0,21,16,83,12,13,138,146,230,154,85,107,41,051,010200,3,410510102003
"Block Group 5, Census Tract 94, Multnomah County, Oregon",495,278,217,495,68,427,495,33,48,0,17,16,0,20,33,23,33,81,138,18,0,35,0,41,051,009400,5,410510094005
"Block Group 1, Census Tract 205.05, Clackamas County, Oregon",690,266,424,690,9,681,690,69,30,9,24,25,0,9,35,0,50,58,104,60,28,96,93,41,005,020505,1,410050205051
"Block Group 1, Census Tract 204.03, Clackamas County, Oregon",915,680,235,915,28,887,915,17,0,36,10,17,18,25,15,0,36,52,68,51,66,126,378,41,005,020403,1,410050204031
"Block Group 1, Census Tract 221.07, Clackamas County, Oregon",1154,1054,100,1154,329,825,1154,61,24,32,17,83,19,64,126,65,71,151,248,46,71,25,51,41,005,022107,1,410050221071
"Block Group 2, Census Tract 221.07, Clackamas County, Oregon",723,481,242,723,104,619,723,0,22,34,34,67,23,13,71,22,20,177,143,66,0,31,0,41,005,022107,2,410050221072
"Block Group 2, Census Tract 221.05, Clackamas County, Oregon",952,821,131,952,164,788,952,38,22,69,15,0,63,31,26,15,56,86,111,155,70,145,50,41,005,022105,2,410050221052
"Block Group 1, Census Tract 221.05, Clackamas County, Oregon",396,381,15,396,46,350,396,0,0,0,0,0,14,0,15,15,0,45,79,32,62,48,86,41,005,022105,1,410050221051
"Block Group 1, Census Tract 221.08, Clackamas County, Oregon",461,317,144,461,77,384,461,15,44,17,51,0,9,46,21,15,70,9,101,20,23,0,20,41,005,022108,1,410050221081
"Block Group 1, Census Tract 222.06, Clackamas County, Oregon",695,524,171,695,50,645,695,0,0,18,37,17,31,42,9,45,50,70,39,55,159,123,0,41,005,022206,1,410050222061
"Block Group 1, Census Tract 222.05, Clackamas County, Oregon",762,614,148,762,23,739,762,0,6,12,20,32,18,18,39,10,10,127,142,73,43,158,54,41,005,022205,1,410050222051
"Block Group 2, Census Tract 222.05, Clackamas County, Oregon",692,547,145,692,47,645,692,22,0,0,0,0,0,26,0,18,19,73,45,120,96,94,179,41,005,022205,2,410050222052
"Block Group 1, Census Tract 222.08, Clackamas County, Oregon",1637,1489,148,1637,45,1592,1637,28,18,37,29,16,0,16,12,46,23,263,206,127,169,254,393,41,005,022208,1,410050222081
"Block Group 3, Census Tract 319.07, Washington County, Oregon",743,291,452,743,89,654,743,109,64,56,55,74,23,50,31,21,68,88,68,11,0,14,11,41,067,031907,3,410670319073
"Block Group 1, Census Tract 319.08, Washington County, Oregon",1608,1393,215,1608,35,1573,1608,14,0,0,0,17,55,36,53,18,64,87,289,172,210,312,281,41,067,031908,1,410670319081
"Block Group 2, Census Tract 319.08, Washington County, Oregon",1352,1159,193,1352,72,1280,1352,20,57,0,0,0,33,0,0,21,34,63,189,176,115,249,395,41,067,031908,2,410670319082
"Block Group 2, Census Tract 318.13, Washington County, Oregon",983,834,149,983,117,866,983,36,99,12,0,19,29,86,18,18,152,106,12,76,84,97,139,41,067,031813,2,410670318132
"Block Group 3, Census Tract 23.02, Lane County, Oregon",370,257,113,370,96,274,370,40,0,0,32,22,17,24,15,8,47,91,40,7,8,19,0,41,039,002302,3,410390023023
"Block Group 1, Census Tract 23.02, Lane County, Oregon",746,641,105,746,104,642,746,0,15,0,9,35,27,21,24,46,16,173,194,88,38,42,18,41,039,002302,1,410390023021
"Block Group 1, Census Tract 7.08, Lane County, Oregon",639,365,274,639,185,454,639,64,48,16,0,54,10,45,21,44,12,48,171,26,56,16,8,41,039,000708,1,410390007081
"Block Group 3, Census Tract 7.07, Lane County, Oregon",688,377,311,688,98,590,688,55,35,54,96,41,48,34,57,15,10,52,105,40,20,0,26,41,039,000707,3,410390007073
"Block Group 2, Census Tract 7.07, Lane County, Oregon",553,242,311,553,64,489,553,37,15,22,36,17,12,41,12,12,53,104,39,133,9,0,11,41,039,000707,2,410390007072
"Block Group 0, Census Tract 9900, Lane County, Oregon",0,0,0,0,0,0,0,0,0,0,0,0,0,0,0,0,0,0,0,0,0,0,0,41,039,990000,0,410399900000
"Block Group 1, Census Tract 25.04, Lane County, Oregon",250,237,13,250,66,184,250,33,8,0,0,0,5,0,14,17,8,57,29,16,19,44,0,41,039,002504,1,410390025041
"Block Group 3, Census Tract 44.05, Lane County, Oregon",619,479,140,619,49,570,619,25,8,8,11,0,11,10,30,0,10,55,123,36,72,146,74,41,039,004405,3,410390044053
"Block Group 2, Census Tract 33.02, Lane County, Oregon",561,463,98,561,225,336,561,40,53,76,8,78,28,28,8,40,72,47,63,13,7,0,0,41,039,003302,2,410390033022
"Block Group 5, Census Tract 39.01, Multnomah County, Oregon",647,574,73,647,92,555,647,14,0,30,0,58,36,33,0,18,70,44,150,86,63,0,45,41,051,003901,5,410510039015
"Block Group 4, Census Tract 39.01, Multnomah County, Oregon",547,475,72,547,146,401,547,0,0,33,14,0,14,52,20,0,10,157,99,59,80,9,0,41,051,003901,4,410510039014
"Block Group 3, Census Tract 39.01, Multnomah County, Oregon",628,506,122,628,63,565,628,61,0,0,0,12,0,0,0,16,64,162,58,92,40,67,56,41,051,003901,3,410510039013
"Block Group 1, Census Tract 39.01, Multnomah County, Oregon",517,483,34,517,19,498,517,10,0,0,0,19,0,16,16,0,62,86,103,99,36,26,44,41,051,003901,1,410510039011
"Block Group 2, Census Tract 39.01, Multnomah County, Oregon",509,386,123,509,52,457,509,13,54,37,24,28,0,0,0,35,0,9,112,58,51,78,10,41,051,003901,2,410510039012
"Block Group 1, Census Tract 55, Multnomah County, Oregon",874,490,384,874,333,541,874,170,160,128,61,20,20,22,12,19,53,15,21,34,24,39,76,41,051,005500,1,410510055001
"Block Group 5, Census Tract 58, Multnomah County, Oregon",401,320,81,401,17,384,401,0,0,0,0,42,0,0,0,0,0,0,59,17,16,40,227,41,051,005800,5,410510058005
"Block Group 3, Census Tract 58, Multnomah County, Oregon",367,352,15,367,21,346,367,30,0,0,0,34,29,15,0,11,49,27,127,10,18,0,17,41,051,005800,3,410510058003
"Block Group 4, Census Tract 58, Multnomah County, Oregon",480,406,74,480,0,480,480,16,0,0,0,0,15,16,0,0,0,0,33,50,57,51,242,41,051,005800,4,410510058004
"Block Group 1, Census Tract 58, Multnomah County, Oregon",505,326,179,505,12,493,505,105,0,51,15,0,0,0,12,15,14,7,14,44,67,45,116,41,051,005800,1,410510058001
"Block Group 2, Census Tract 58, Multnomah County, Oregon",620,316,304,620,63,557,620,81,25,13,27,15,15,16,74,0,32,35,99,58,0,50,80,41,051,005800,2,410510058002
"Block Group 1, Census Tract 59, Multnomah County, Oregon",3202,2319,883,3202,52,3150,3202,251,76,122,107,31,73,51,78,26,232,265,304,331,380,452,423,41,051,005900,1,410510059001
"Block Group 3, Census Tract 24.01, Multnomah County, Oregon",336,314,22,336,20,316,336,0,0,0,9,0,49,0,27,0,8,26,23,87,8,19,80,41,051,002401,3,410510024013
"Block Group 2, Census Tract 34.02, Multnomah County, Oregon",535,491,44,535,80,455,535,9,0,12,11,0,32,0,33,43,46,71,80,101,22,12,63,41,051,003402,2,410510034022
"Block Group 3, Census Tract 34.02, Multnomah County, Oregon",708,660,48,708,59,649,708,14,40,0,21,23,0,10,22,23,57,56,165,91,0,46,140,41,051,003402,3,410510034023
"Block Group 4, Census Tract 35.01, Multnomah County, Oregon",339,296,43,339,120,219,339,8,51,17,7,52,11,36,15,44,16,0,42,10,11,8,11,41,051,003501,4,410510035014
"Block Group 2, Census Tract 35.01, Multnomah County, Oregon",479,433,46,479,46,433,479,0,0,10,8,13,7,28,0,14,10,34,107,45,74,53,76,41,051,003501,2,410510035012
"Block Group 1, Census Tract 35.01, Multnomah County, Oregon",368,329,39,368,83,285,368,58,16,62,46,0,8,10,0,27,37,23,41,17,23,0,0,41,051,003501,1,410510035011
"Block Group 4, Census Tract 1, Lane County, Oregon",404,266,138,404,108,296,404,33,34,12,8,43,19,21,9,19,46,10,81,8,16,36,9,41,039,000100,4,410390001004
"Block Group 1, Census Tract 1, Lane County, Oregon",498,307,191,498,48,450,498,0,32,0,48,63,55,13,0,65,81,0,41,28,32,0,40,41,039,000100,1,410390001001
"Block Group 3, Census Tract 1, Lane County, Oregon",538,303,235,538,56,482,538,11,0,5,26,26,33,53,22,25,38,80,79,30,60,24,26,41,039,000100,3,410390001003
"Block Group 3, Census Tract 5, Lane County, Oregon",380,259,121,380,73,307,380,40,10,23,37,18,29,16,43,9,16,21,57,29,9,15,8,41,039,000500,3,410390005003
"Block Group 2, Census Tract 5, Lane County, Oregon",177,101,76,177,66,111,177,18,17,7,20,0,43,11,17,7,0,4,16,3,11,3,0,41,039,000500,2,410390005002
"Block Group 2, Census Tract 8, Lane County, Oregon",379,253,126,379,44,335,379,14,6,21,0,10,0,5,17,11,24,49,51,77,27,40,27,41,039,000800,2,410390008002
"Block Group 1, Census Tract 31.01, Lane County, Oregon",670,433,237,670,32,638,670,19,34,52,17,16,17,0,0,17,64,38,191,64,36,55,50,41,039,003101,1,410390031011
"Block Group 2, Census Tract 31.01, Lane County, Oregon",588,419,169,588,106,482,588,0,0,0,39,8,19,68,17,19,45,84,128,58,11,56,36,41,039,003101,2,410390031012
"Block Group 3, Census Tract 40, Lane County, Oregon",320,260,60,320,95,225,320,34,29,9,10,27,6,9,16,9,18,45,42,12,7,38,9,41,039,004000,3,410390040003
"Block Group 2, Census Tract 40, Lane County, Oregon",344,311,33,344,131,213,344,49,16,17,18,11,25,42,0,0,15,36,52,49,0,8,6,41,039,004000,2,410390040002
"Block Group 4, Census Tract 44.01, Lane County, Oregon",582,204,378,582,66,516,582,66,33,209,13,18,0,33,17,0,19,62,49,3,0,6,54,41,039,004401,4,410390044014
"Block Group 1, Census Tract 7, Coos County, Oregon",551,392,159,551,268,283,551,116,47,14,11,0,0,15,24,35,15,51,33,100,74,0,16,41,011,000700,1,410110007001
"Block Group 7, Census Tract 7, Coos County, Oregon",423,352,71,423,31,392,423,14,13,0,0,11,17,0,35,42,129,79,22,46,15,0,0,41,011,000700,7,410110007007
"Block Group 3, Census Tract 7, Coos County, Oregon",108,78,30,108,27,81,108,0,0,0,17,0,10,0,0,0,13,15,37,0,0,0,16,41,011,000700,3,410110007003
"Block Group 8, Census Tract 7, Coos County, Oregon",650,547,103,650,186,464,650,76,20,20,16,73,21,95,50,15,0,126,54,0,40,18,26,41,011,000700,8,410110007008
"Block Group 4, Census Tract 7, Coos County, Oregon",368,261,107,368,114,254,368,15,0,80,30,21,111,0,62,0,22,7,0,20,0,0,0,41,011,000700,4,410110007004
"Block Group 6, Census Tract 7, Coos County, Oregon",536,312,224,536,133,403,536,39,0,21,22,67,0,16,178,9,31,52,60,41,0,0,0,41,011,000700,6,410110007006
"Block Group 6, Census Tract 10, Coos County, Oregon",389,208,181,389,32,357,389,15,25,121,41,21,18,0,62,0,0,17,16,0,0,38,15,41,011,001000,6,410110010006
"Block Group 7, Census Tract 10, Coos County, Oregon",495,246,249,495,135,360,495,35,24,76,32,26,49,23,19,39,35,84,38,15,0,0,0,41,011,001000,7,410110010007
"Block Group 1, Census Tract 10, Coos County, Oregon",272,145,127,272,37,235,272,0,51,34,0,12,0,9,0,27,34,32,52,11,0,10,0,41,011,001000,1,410110010001
"Block Group 1, Census Tract 11, Coos County, Oregon",292,152,140,292,80,212,292,13,0,77,5,0,19,0,0,0,0,99,13,30,11,11,14,41,011,001100,1,410110011001
"Block Group 3, Census Tract 21.02, Lane County, Oregon",1008,791,217,1008,208,800,1008,35,91,0,71,50,54,60,97,120,56,236,34,66,0,38,0,41,039,002102,3,410390021023
"Block Group 3, Census Tract 301, Linn County, Oregon",328,290,38,328,5,323,328,0,0,29,20,0,12,0,0,0,0,94,40,49,0,60,24,41,043,030100,3,410430301003
"Block Group 1, Census Tract 9602, Tillamook County, Oregon",315,200,115,315,62,253,315,22,19,11,24,20,31,20,18,9,27,59,22,22,2,0,9,41,057,960200,1,410579602001
"Block Group 1, Census Tract 68.01, Multnomah County, Oregon",1085,747,338,1085,200,885,1085,72,76,29,45,0,90,24,68,29,62,53,92,50,34,95,266,41,051,006801,1,410510068011
"Block Group 2, Census Tract 95.01, Multnomah County, Oregon",756,521,235,756,95,661,756,0,0,70,95,19,67,69,33,0,22,60,99,70,45,41,66,41,051,009501,2,410510095012
"Block Group 2, Census Tract 94, Multnomah County, Oregon",434,402,32,434,69,365,434,0,0,15,0,17,24,31,33,15,22,31,95,67,0,38,46,41,051,009400,2,410510094002
"Block Group 3, Census Tract 94, Multnomah County, Oregon",538,413,125,538,92,446,538,17,37,0,17,17,65,15,0,19,66,28,88,62,36,33,38,41,051,009400,3,410510094003
"Block Group 4, Census Tract 94, Multnomah County, Oregon",435,332,103,435,32,403,435,18,0,14,0,0,20,15,18,16,61,18,53,86,80,36,0,41,051,009400,4,410510094004
"Block Group 2, Census Tract 9703, Union County, Oregon",659,451,208,659,50,609,659,22,34,41,53,12,27,20,37,39,50,98,88,44,15,43,36,41,061,970300,2,410619703002
"Block Group 1, Census Tract 9707, Union County, Oregon",421,313,108,421,122,299,421,48,18,32,19,124,31,9,0,30,0,13,84,0,13,0,0,41,061,970700,1,410619707001
"Block Group 3, Census Tract 9707, Union County, Oregon",660,495,165,660,249,411,660,34,114,47,53,99,0,81,13,21,84,33,7,39,0,0,35,41,061,970700,3,410619707003
"Block Group 2, Census Tract 324.06, Washington County, Oregon",434,369,65,434,0,434,434,15,0,0,0,17,0,16,15,20,34,31,94,101,19,72,0,41,067,032406,2,410670324062
"Block Group 1, Census Tract 34, Lane County, Oregon",530,448,82,530,338,192,530,11,46,159,20,11,30,26,9,27,119,18,47,7,0,0,0,41,039,003400,1,410390034001
"Block Group 2, Census Tract 34, Lane County, Oregon",399,260,139,399,67,332,399,23,23,0,0,26,37,42,34,23,41,29,92,8,15,6,0,41,039,003400,2,410390034002
"Block Group 3, Census Tract 34, Lane County, Oregon",655,526,129,655,249,406,655,123,61,35,59,10,71,6,10,41,58,52,56,73,0,0,0,41,039,003400,3,410390034003
"Block Group 4, Census Tract 34, Lane County, Oregon",428,411,17,428,207,221,428,0,29,9,8,17,57,43,26,32,59,93,11,29,0,8,7,41,039,003400,4,410390034004
"Block Group 2, Census Tract 41, Lane County, Oregon",535,474,61,535,70,465,535,26,31,19,9,0,40,20,16,9,80,49,73,92,28,15,28,41,039,004100,2,410390041002
"Block Group 1, Census Tract 41, Lane County, Oregon",419,330,89,419,119,300,419,56,0,52,47,28,19,10,20,23,32,9,0,67,33,7,16,41,039,004100,1,410390041001
"Block Group 3, Census Tract 41, Lane County, Oregon",482,379,103,482,55,427,482,0,40,10,36,0,6,15,81,26,72,47,80,50,10,9,0,41,039,004100,3,410390041003
"Block Group 4, Census Tract 41, Lane County, Oregon",318,215,103,318,39,279,318,16,0,0,0,20,10,26,43,11,26,38,55,20,8,17,28,41,039,004100,4,410390041004
"Block Group 1, Census Tract 49, Lane County, Oregon",569,506,63,569,54,515,569,27,21,0,11,0,0,11,0,0,28,25,64,96,31,86,169,41,039,004900,1,410390049001
"Block Group 3, Census Tract 49, Lane County, Oregon",450,397,53,450,50,400,450,34,0,19,9,6,20,10,11,17,49,24,88,63,36,20,44,41,039,004900,3,410390049003
"Block Group 1, Census Tract 17.02, Multnomah County, Oregon",712,607,105,712,101,611,712,67,17,57,24,10,78,7,40,10,57,39,146,71,49,40,0,41,051,001702,1,410510017021
"Block Group 2, Census Tract 17.02, Multnomah County, Oregon",446,424,22,446,98,348,446,0,0,21,24,27,8,8,55,19,25,38,61,40,72,19,29,41,051,001702,2,410510017022
"Block Group 3, Census Tract 17.02, Multnomah County, Oregon",433,377,56,433,37,396,433,11,0,18,0,8,9,8,42,0,60,38,128,41,12,31,27,41,051,001702,3,410510017023
"Block Group 4, Census Tract 19, Multnomah County, Oregon",480,403,77,480,8,472,480,12,0,0,0,18,9,0,28,17,0,10,54,46,85,67,134,41,051,001900,4,410510019004
"Block Group 1, Census Tract 19, Multnomah County, Oregon",586,479,107,586,44,542,586,24,8,41,21,22,22,11,50,31,40,45,49,60,46,53,63,41,051,001900,1,410510019001
"Block Group 1, Census Tract 25.01, Multnomah County, Oregon",262,217,45,262,6,256,262,7,0,0,7,0,9,0,0,0,15,7,0,25,50,60,82,41,051,002501,1,410510025011
"Block Group 5, Census Tract 25.01, Multnomah County, Oregon",290,248,42,290,6,284,290,0,0,0,0,0,13,0,0,0,0,27,50,34,25,22,119,41,051,002501,5,410510025015
"Block Group 4, Census Tract 25.01, Multnomah County, Oregon",227,178,49,227,0,227,227,0,0,9,8,0,0,0,24,7,28,23,13,16,16,9,74,41,051,002501,4,410510025014
"Block Group 6, Census Tract 25.01, Multnomah County, Oregon",244,213,31,244,0,244,244,0,0,0,8,0,0,0,0,0,18,8,25,36,0,36,113,41,051,002501,6,410510025016
"Block Group 2, Census Tract 26, Multnomah County, Oregon",351,280,71,351,0,351,351,12,0,0,0,0,0,4,6,9,30,43,28,64,20,42,93,41,051,002600,2,410510026002
"Block Group 3, Census Tract 26, Multnomah County, Oregon",329,266,63,329,0,329,329,28,0,11,0,0,29,0,0,0,9,19,65,26,7,83,52,41,051,002600,3,410510026003
"Block Group 2, Census Tract 27.02, Multnomah County, Oregon",1092,663,429,1092,387,705,1092,237,145,12,34,71,15,24,21,34,58,68,90,27,90,86,80,41,051,002702,2,410510027022
"Block Group 1, Census Tract 29.02, Multnomah County, Oregon",478,439,39,478,34,444,478,17,0,17,35,0,0,0,42,17,36,63,87,141,0,0,23,41,051,002902,1,410510029021
"Block Group 2, Census Tract 29.02, Multnomah County, Oregon",361,324,37,361,0,361,361,0,22,0,22,2,0,0,0,18,62,92,40,88,0,0,15,41,051,002902,2,410510029022
"Block Group 4, Census Tract 29.02, Multnomah County, Oregon",643,546,97,643,225,418,643,33,30,78,0,8,19,102,46,77,48,41,49,73,26,13,0,41,051,002902,4,410510029024
"Block Group 1, Census Tract 20, Deschutes County, Oregon",619,300,319,619,12,607,619,25,0,13,0,41,46,14,13,13,0,42,159,146,13,23,71,41,017,002000,1,410170020001
"Block Group 3, Census Tract 218.01, Clackamas County, Oregon",736,491,245,736,20,716,736,16,19,0,0,47,49,29,56,0,0,38,160,142,19,44,117,41,005,021801,3,410050218013
"Block Group 3, Census Tract 17.01, Multnomah County, Oregon",245,191,54,245,0,245,245,0,0,17,0,0,0,0,14,24,16,0,45,47,15,0,67,41,051,001701,3,410510017013
"Block Group 2, Census Tract 17.01, Multnomah County, Oregon",719,529,190,719,177,542,719,23,75,28,33,0,45,50,30,14,40,117,27,127,0,31,79,41,051,001701,2,410510017012
"Block Group 7, Census Tract 17.01, Multnomah County, Oregon",611,584,27,611,145,466,611,8,61,16,0,0,59,28,13,13,103,71,149,53,0,16,21,41,051,001701,7,410510017017
"Block Group 4, Census Tract 17.01, Multnomah County, Oregon",309,274,35,309,49,260,309,26,17,0,12,0,7,34,18,0,49,15,12,38,0,22,59,41,051,001701,4,410510017014
"Block Group 5, Census Tract 17.01, Multnomah County, Oregon",442,344,98,442,60,382,442,0,12,0,37,0,16,17,0,41,37,71,32,118,36,16,9,41,051,001701,5,410510017015
"Block Group 1, Census Tract 66.02, Multnomah County, Oregon",445,345,100,445,61,384,445,21,0,17,40,0,82,0,0,35,0,107,28,50,27,16,22,41,051,006602,1,410510066021
"Block Group 2, Census Tract 66.02, Multnomah County, Oregon",1293,1141,152,1293,124,1169,1293,33,32,55,92,54,26,88,37,83,80,120,233,82,37,117,124,41,051,006602,2,410510066022
"Block Group 3, Census Tract 66.02, Multnomah County, Oregon",777,618,159,777,20,757,777,41,14,0,14,63,60,0,0,19,26,99,79,117,79,32,134,41,051,006602,3,410510066023
"Block Group 1, Census Tract 7.02, Multnomah County, Oregon",520,355,165,520,147,373,520,26,12,62,0,49,26,16,73,0,15,66,80,17,35,29,14,41,051,000702,1,410510007021
"Block Group 3, Census Tract 7.02, Multnomah County, Oregon",563,516,47,563,129,434,563,23,120,25,0,0,0,12,36,14,58,30,108,41,77,19,0,41,051,000702,3,410510007023
"Block Group 2, Census Tract 7.02, Multnomah County, Oregon",494,386,108,494,78,416,494,38,42,25,0,0,0,15,14,17,0,26,112,120,33,18,34,41,051,000702,2,410510007022
"Block Group 4, Census Tract 7.02, Multnomah County, Oregon",507,470,37,507,182,325,507,0,42,13,0,44,15,57,0,0,28,58,91,72,74,13,0,41,051,000702,4,410510007024
"Block Group 1, Census Tract 18.01, Multnomah County, Oregon",659,472,187,659,165,494,659,42,89,20,85,0,34,15,46,0,61,34,97,37,81,18,0,41,051,001801,1,410510018011
"Block Group 2, Census Tract 18.01, Multnomah County, Oregon",582,483,99,582,106,476,582,42,29,0,0,0,76,15,50,32,25,93,69,40,26,51,34,41,051,001801,2,410510018012
"Block Group 1, Census Tract 18.02, Multnomah County, Oregon",1052,820,232,1052,62,990,1052,36,30,35,36,13,98,42,84,33,68,94,132,87,129,63,72,41,051,001802,1,410510018021
"Block Group 2, Census Tract 21, Multnomah County, Oregon",987,842,145,987,222,765,987,72,18,60,86,50,47,87,57,19,69,125,82,80,36,48,51,41,051,002100,2,410510021002
"Block Group 2, Census Tract 104, Marion County, Oregon",445,199,246,445,82,363,445,32,9,87,48,26,14,0,8,18,37,20,48,42,22,27,7,41,047,010400,2,410470104002
"Block Group 3, Census Tract 104, Marion County, Oregon",292,214,78,292,25,267,292,8,67,0,8,0,0,0,17,0,8,63,34,35,47,5,0,41,047,010400,3,410470104003
"Block Group 4, Census Tract 104, Marion County, Oregon",570,429,141,570,129,441,570,38,29,92,0,18,32,111,16,24,28,8,131,9,0,34,0,41,047,010400,4,410470104004
"Block Group 3, Census Tract 103.05, Marion County, Oregon",461,419,42,461,128,333,461,10,29,9,0,35,7,11,22,22,59,97,36,60,11,41,12,41,047,010305,3,410470103053
"Block Group 1, Census Tract 103.05, Marion County, Oregon",486,386,100,486,128,358,486,43,0,21,0,58,6,86,64,49,47,43,47,0,22,0,0,41,047,010305,1,410470103051
"Block Group 2, Census Tract 103.05, Marion County, Oregon",297,286,11,297,75,222,297,16,0,9,36,10,39,42,9,26,7,9,52,0,17,7,18,41,047,010305,2,410470103052
"Block Group 1, Census Tract 315.09, Washington County, Oregon",2134,1981,153,2134,165,1969,2134,63,71,17,52,99,63,65,23,20,103,103,239,238,173,333,472,41,067,031509,1,410670315091
"Block Group 2, Census Tract 100.02, Multnomah County, Oregon",989,859,130,989,178,811,989,51,0,20,38,39,21,32,10,0,90,171,136,227,26,69,59,41,051,010002,2,410510100022
"Block Group 1, Census Tract 6, Deschutes County, Oregon",1802,1086,716,1802,87,1715,1802,48,30,0,16,20,47,138,47,64,177,217,202,317,75,209,195,41,017,000600,1,410170006001
"Block Group 2, Census Tract 6, Deschutes County, Oregon",410,363,47,410,31,379,410,16,0,0,0,0,0,14,11,76,0,62,50,80,26,46,29,41,017,000600,2,410170006002
"Block Group 4, Census Tract 6, Deschutes County, Oregon",784,587,197,784,72,712,784,47,0,16,50,15,62,0,14,46,27,86,162,93,29,70,67,41,017,000600,4,410170006004
"Block Group 1, Census Tract 4.02, Deschutes County, Oregon",634,474,160,634,61,573,634,8,9,19,11,73,25,33,32,7,42,108,126,22,22,68,29,41,017,000402,1,410170004021
"Block Group 2, Census Tract 4.02, Deschutes County, Oregon",347,86,261,347,0,347,347,0,0,0,8,30,28,27,9,25,30,27,115,0,10,11,27,41,017,000402,2,410170004022
"Block Group 3, Census Tract 4.02, Deschutes County, Oregon",125,53,72,125,0,125,125,0,6,0,0,0,8,0,0,0,0,0,23,0,43,18,27,41,017,000402,3,410170004023
"Block Group 3, Census Tract 19.02, Deschutes County, Oregon",350,335,15,350,12,338,350,0,0,15,12,0,0,16,0,26,0,19,54,67,78,0,63,41,017,001902,3,410170019023
"Block Group 4, Census Tract 19.02, Deschutes County, Oregon",563,390,173,563,0,563,563,0,0,15,14,15,33,0,28,0,43,61,64,70,35,60,125,41,017,001902,4,410170019024
"Block Group 1, Census Tract 19.02, Deschutes County, Oregon",2448,1759,689,2448,179,2269,2448,171,115,134,77,22,84,80,150,237,168,200,399,281,87,101,142,41,017,001902,1,410170019021
"Block Group 2, Census Tract 19.02, Deschutes County, Oregon",706,536,170,706,61,645,706,0,17,0,60,15,69,65,40,34,93,50,83,97,40,14,29,41,017,001902,2,410170019022
"Block Group 1, Census Tract 19.01, Deschutes County, Oregon",697,504,193,697,23,674,697,35,0,6,7,0,19,18,24,59,51,60,147,84,47,85,55,41,017,001901,1,410170019011
"Block Group 1, Census Tract 10.02, Deschutes County, Oregon",959,694,265,959,70,889,959,27,30,39,79,27,7,41,43,51,71,83,120,77,48,124,92,41,017,001002,1,410170010021
"Block Group 1, Census Tract 10.01, Deschutes County, Oregon",985,408,577,985,59,926,985,17,53,27,82,84,56,0,56,54,97,66,95,220,52,26,0,41,017,001001,1,410170010011
"Block Group 5, Census Tract 10.01, Deschutes County, Oregon",1101,951,150,1101,322,779,1101,0,0,143,43,24,14,24,59,0,15,329,239,83,74,25,29,41,017,001001,5,410170010015
"Block Group 2, Census Tract 10.01, Jackson County, Oregon",206,75,131,206,13,193,206,12,25,43,38,0,13,16,0,0,0,0,59,0,0,0,0,41,029,001001,2,410290010012
"Block Group 1, Census Tract 10.01, Jackson County, Oregon",688,573,115,688,198,490,688,32,0,0,22,60,90,45,0,45,46,57,146,18,34,93,0,41,029,001001,1,410290010011
"Block Group 5, Census Tract 7, Jackson County, Oregon",1092,867,225,1092,163,929,1092,99,0,16,14,115,0,61,22,57,115,100,318,60,68,35,12,41,029,000700,5,410290007005
"Block Group 4, Census Tract 15, Jackson County, Oregon",826,416,410,826,131,695,826,22,58,138,18,43,49,0,16,18,94,84,124,66,0,21,75,41,029,001500,4,410290015004
"Block Group 4, Census Tract 6.01, Jackson County, Oregon",653,366,287,653,28,625,653,0,13,49,0,44,33,56,16,42,145,120,31,14,90,0,0,41,029,000601,4,410290006014
"Block Group 1, Census Tract 243.03, Clackamas County, Oregon",687,423,264,687,55,632,687,30,25,89,0,10,30,0,88,7,63,28,175,54,59,20,9,41,005,024303,1,410050243031
"Block Group 2, Census Tract 243.03, Clackamas County, Oregon",551,275,276,551,73,478,551,30,12,21,19,51,23,0,9,20,82,96,45,58,37,9,39,41,005,024303,2,410050243032
"Block Group 2, Census Tract 243.04, Clackamas County, Oregon",193,128,65,193,0,193,193,12,13,12,0,30,12,0,0,0,0,29,18,44,7,16,0,41,005,024304,2,410050243042
"Block Group 3, Census Tract 20, Marion County, Oregon",952,667,285,952,167,785,952,135,54,0,16,24,15,15,22,14,79,182,103,141,66,69,17,41,047,002000,3,410470020003
"Block Group 1, Census Tract 243.04, Clackamas County, Oregon",841,658,183,841,129,712,841,62,30,8,11,33,21,13,23,33,31,83,84,99,85,102,123,41,005,024304,1,410050243041
"Block Group 2, Census Tract 221.03, Clackamas County, Oregon",1587,1417,170,1587,47,1540,1587,21,26,57,14,15,0,55,0,41,142,143,344,315,107,48,259,41,005,022103,2,410050221032
"Block Group 3, Census Tract 23.03, Marion County, Oregon",846,681,165,846,185,661,846,12,109,79,58,0,11,121,11,0,134,121,75,83,22,10,0,41,047,002303,3,410470023033
"Block Group 1, Census Tract 23.03, Marion County, Oregon",1200,979,221,1200,133,1067,1200,52,0,47,100,18,35,83,33,99,22,203,155,126,106,65,56,41,047,002303,1,410470023031
"Block Group 1, Census Tract 22.02, Marion County, Oregon",1031,766,265,1031,87,944,1031,15,17,30,32,55,18,52,23,31,16,40,221,138,132,137,74,41,047,002202,1,410470022021
"Block Group 2, Census Tract 22.02, Marion County, Oregon",423,407,16,423,11,412,423,12,0,44,0,20,23,15,45,20,55,28,107,43,11,0,0,41,047,002202,2,410470022022
"Block Group 2, Census Tract 21.01, Marion County, Oregon",353,304,49,353,34,319,353,0,0,0,31,9,12,0,25,0,24,65,52,75,9,51,0,41,047,002101,2,410470021012
"Block Group 2, Census Tract 25.01, Marion County, Oregon",790,701,89,790,157,633,790,0,49,0,0,14,0,86,27,25,78,28,215,110,97,48,13,41,047,002501,2,410470025012
"Block Group 1, Census Tract 23.04, Marion County, Oregon",1109,883,226,1109,30,1079,1109,54,0,17,10,0,19,0,27,78,66,31,59,129,147,286,186,41,047,002304,1,410470023041
"Block Group 2, Census Tract 23.04, Marion County, Oregon",156,138,18,156,27,129,156,18,0,0,0,0,26,0,0,0,13,30,13,26,0,10,20,41,047,002304,2,410470023042
"Block Group 4, Census Tract 23.04, Marion County, Oregon",322,195,127,322,33,289,322,20,0,0,16,0,17,0,0,19,74,31,30,77,34,4,0,41,047,002304,4,410470023044
"Block Group 1, Census Tract 102.02, Marion County, Oregon",586,289,297,586,134,452,586,16,5,0,47,67,25,99,0,93,19,46,83,19,14,1,52,41,047,010202,1,410470102021
"Block Group 3, Census Tract 102.02, Marion County, Oregon",289,196,93,289,72,217,289,0,0,0,35,29,36,0,11,0,60,18,58,18,11,13,0,41,047,010202,3,410470102023
"Block Group 1, Census Tract 229.04, Clackamas County, Oregon",700,574,126,700,152,548,700,12,0,0,71,25,57,24,6,29,103,100,174,47,31,21,0,41,005,022904,1,410050229041
"Block Group 2, Census Tract 229.04, Clackamas County, Oregon",673,515,158,673,128,545,673,69,33,16,43,25,39,14,0,36,45,91,122,92,21,7,20,41,005,022904,2,410050229042
"Block Group 2, Census Tract 229.05, Clackamas County, Oregon",610,508,102,610,10,600,610,0,0,0,8,17,0,0,8,0,27,25,152,79,47,128,119,41,005,022905,2,410050229052
"Block Group 1, Census Tract 229.05, Clackamas County, Oregon",483,367,116,483,6,477,483,7,0,0,10,12,9,0,6,40,10,61,119,76,69,49,15,41,005,022905,1,410050229051
"Block Group 1, Census Tract 230.02, Clackamas County, Oregon",609,448,161,609,41,568,609,12,22,26,8,21,0,5,20,0,30,67,103,77,60,90,68,41,005,023002,1,410050230021
"Block Group 1, Census Tract 9601, Wheeler County, Oregon",260,146,114,260,55,205,260,6,18,31,6,45,18,2,25,17,30,29,10,13,4,4,2,41,069,960100,1,410699601001
"Block Group 2, Census Tract 12, Deschutes County, Oregon",196,130,66,196,25,171,196,14,0,0,0,10,15,13,15,0,0,46,65,10,0,0,8,41,017,001200,2,410170012002
"Block Group 4, Census Tract 312, Washington County, Oregon",824,534,290,824,185,639,824,74,21,98,95,33,19,36,72,30,64,73,98,67,32,0,12,41,067,031200,4,410670312004
"Block Group 2, Census Tract 11.01, Multnomah County, Oregon",953,785,168,953,124,829,953,104,52,61,40,52,15,46,45,45,49,145,122,33,23,32,89,41,051,001101,2,410510011012
"Block Group 4, Census Tract 9709, Malheur County, Oregon",184,152,32,184,24,160,184,16,6,0,0,23,0,10,8,3,38,8,17,21,0,18,16,41,045,970900,4,410459709004
"Block Group 1, Census Tract 9709, Malheur County, Oregon",257,181,76,257,40,217,257,21,11,6,23,19,13,6,9,7,11,21,16,45,14,19,16,41,045,970900,1,410459709001
"Block Group 3, Census Tract 24.01, Lane County, Oregon",631,451,180,631,83,548,631,33,9,9,45,19,12,9,7,10,36,96,126,96,57,41,26,41,039,002401,3,410390024013
"Block Group 3, Census Tract 208.02, Linn County, Oregon",617,536,81,617,205,412,617,0,127,0,68,0,23,57,27,10,82,162,12,41,0,8,0,41,043,020802,3,410430208023
"Block Group 1, Census Tract 208.02, Linn County, Oregon",441,376,65,441,172,269,441,48,20,11,8,0,31,27,33,17,34,84,25,77,0,26,0,41,043,020802,1,410430208021
"Block Group 4, Census Tract 208.02, Linn County, Oregon",718,532,186,718,309,409,718,60,35,132,24,16,66,60,0,11,0,93,156,26,0,0,39,41,043,020802,4,410430208024
"Block Group 1, Census Tract 24.02, Multnomah County, Oregon",671,461,210,671,100,571,671,78,52,38,13,86,37,18,0,10,39,84,47,31,21,52,65,41,051,002402,1,410510024021
"Block Group 3, Census Tract 24.02, Multnomah County, Oregon",566,471,95,566,106,460,566,0,55,28,16,10,57,0,26,29,50,30,33,55,38,39,100,41,051,002402,3,410510024023
"Block Group 1, Census Tract 29.03, Multnomah County, Oregon",713,502,211,713,185,528,713,63,90,35,0,35,71,13,81,19,9,0,56,117,20,82,22,41,051,002903,1,410510029031
"Block Group 2, Census Tract 29.03, Multnomah County, Oregon",455,306,149,455,20,435,455,32,15,0,54,0,0,32,17,0,20,103,63,24,59,36,0,41,051,002903,2,410510029032
"Block Group 4, Census Tract 29.03, Multnomah County, Oregon",572,523,49,572,48,524,572,0,0,33,84,0,15,0,25,14,104,48,52,29,42,126,0,41,051,002903,4,410510029034
"Block Group 1, Census Tract 33.01, Multnomah County, Oregon",450,351,99,450,90,360,450,8,44,8,9,9,0,0,46,0,23,44,41,51,33,51,83,41,051,003301,1,410510033011
"Block Group 2, Census Tract 33.01, Multnomah County, Oregon",454,407,47,454,211,243,454,170,0,14,20,9,22,0,13,39,33,15,48,16,10,20,25,41,051,003301,2,410510033012
"Block Group 2, Census Tract 37.02, Multnomah County, Oregon",256,203,53,256,43,213,256,5,19,5,0,0,6,13,0,14,18,19,25,42,43,16,31,41,051,003702,2,410510037022
"Block Group 3, Census Tract 37.02, Multnomah County, Oregon",485,356,129,485,147,338,485,89,40,20,0,27,14,0,14,0,43,36,50,34,36,48,34,41,051,003702,3,410510037023
"Block Group 1, Census Tract 329.02, Washington County, Oregon",430,352,78,430,61,369,430,18,20,0,16,62,20,0,0,52,105,76,49,0,12,0,0,41,067,032902,1,410670329021
"Block Group 2, Census Tract 99.03, Multnomah County, Oregon",630,500,130,630,70,560,630,0,24,17,0,0,10,48,40,17,93,26,84,16,57,162,36,41,051,009903,2,410510099032
"Block Group 2, Census Tract 101, Multnomah County, Oregon",1871,1570,301,1871,309,1562,1871,76,57,22,102,89,54,88,95,48,387,168,327,162,87,73,36,41,051,010100,2,410510101002
"Block Group 1, Census Tract 101, Multnomah County, Oregon",303,268,35,303,15,288,303,0,15,0,0,24,20,21,0,16,31,106,0,33,16,21,0,41,051,010100,1,410510101001
"Block Group 3, Census Tract 101, Multnomah County, Oregon",848,430,418,848,248,600,848,112,0,52,110,19,0,51,60,35,52,77,147,30,74,14,15,41,051,010100,3,410510101003
"Block Group 1, Census Tract 103.06, Multnomah County, Oregon",515,476,39,515,56,459,515,27,0,0,0,12,0,49,15,25,14,39,107,93,45,45,44,41,051,010306,1,410510103061
"Block Group 1, Census Tract 104.09, Multnomah County, Oregon",1752,1440,312,1752,146,1606,1752,78,12,31,20,42,57,89,122,75,209,294,167,165,195,180,16,41,051,010409,1,410510104091
"Block Group 3, Census Tract 104.09, Multnomah County, Oregon",394,293,101,394,0,394,394,0,0,0,0,0,0,0,13,15,28,44,93,31,63,107,0,41,051,010409,3,410510104093
"Block Group 6, Census Tract 16.01, Multnomah County, Oregon",289,203,86,289,43,246,289,49,0,15,0,0,0,10,29,0,8,0,15,56,58,34,15,41,051,001601,6,410510016016
"Block Group 4, Census Tract 16.01, Multnomah County, Oregon",679,362,317,679,16,663,679,17,15,13,0,0,93,94,0,65,17,77,53,51,37,121,26,41,051,001601,4,410510016014
"Block Group 2, Census Tract 16.01, Multnomah County, Oregon",256,163,93,256,13,243,256,13,0,31,0,8,0,0,0,0,32,21,58,21,0,58,14,41,051,001601,2,410510016012
"Block Group 3, Census Tract 16.01, Multnomah County, Oregon",513,331,182,513,105,408,513,81,0,32,0,90,32,31,0,8,61,50,25,45,13,31,14,41,051,001601,3,410510016013
"Block Group 1, Census Tract 6.01, Multnomah County, Oregon",691,560,131,691,166,525,691,42,28,13,64,95,15,29,19,7,51,58,127,106,18,19,0,41,051,000601,1,410510006011
"Block Group 4, Census Tract 9.01, Multnomah County, Oregon",470,433,37,470,49,421,470,0,24,0,14,0,10,18,17,17,53,44,49,55,50,48,71,41,051,000901,4,410510009014
"Block Group 2, Census Tract 9.01, Multnomah County, Oregon",465,431,34,465,32,433,465,9,0,0,24,23,16,15,0,26,42,52,86,68,55,23,26,41,051,000901,2,410510009012
"Block Group 1, Census Tract 9.01, Multnomah County, Oregon",625,559,66,625,0,625,625,15,4,0,61,0,34,0,0,37,32,40,59,162,0,77,104,41,051,000901,1,410510009011
"Block Group 2, Census Tract 324.10, Washington County, Oregon",376,313,63,376,31,345,376,0,0,23,0,25,0,0,24,43,21,108,79,27,14,7,5,41,067,032410,2,410670324102
"Block Group 3, Census Tract 324.10, Washington County, Oregon",276,163,113,276,99,177,276,72,22,41,0,0,6,4,20,0,0,13,90,8,0,0,0,41,067,032410,3,410670324103
"Block Group 1, Census Tract 325.02, Washington County, Oregon",1032,877,155,1032,127,905,1032,19,40,7,76,10,71,23,9,31,69,83,166,193,102,84,49,41,067,032502,1,410670325021
"Block Group 1, Census Tract 325.01, Washington County, Oregon",631,458,173,631,246,385,631,27,69,31,33,70,57,35,7,27,46,89,66,21,0,44,9,41,067,032501,1,410670325011
"Block Group 2, Census Tract 325.01, Washington County, Oregon",293,246,47,293,77,216,293,31,7,0,13,5,51,24,18,0,39,24,16,26,31,8,0,41,067,032501,2,410670325012
"Block Group 5, Census Tract 315.08, Washington County, Oregon",494,445,49,494,34,460,494,14,15,0,0,0,14,20,0,0,16,12,33,54,11,82,223,41,067,031508,5,410670315085
"Block Group 4, Census Tract 315.08, Washington County, Oregon",482,437,45,482,0,482,482,18,0,0,0,0,0,0,0,0,0,0,15,21,31,75,322,41,067,031508,4,410670315084
"Block Group 3, Census Tract 329.02, Washington County, Oregon",383,329,54,383,57,326,383,0,0,0,0,33,125,0,0,0,0,55,21,57,35,57,0,41,067,032902,3,410670329023
"Block Group 4, Census Tract 329.02, Washington County, Oregon",688,611,77,688,115,573,688,0,38,19,20,51,0,19,0,17,0,239,147,60,28,14,36,41,067,032902,4,410670329024
"Block Group 4, Census Tract 308.03, Washington County, Oregon",604,123,481,604,31,573,604,73,56,15,61,33,29,27,59,27,142,0,25,0,13,30,14,41,067,030803,4,410670308034
"Block Group 2, Census Tract 5.01, Marion County, Oregon",661,563,98,661,149,512,661,28,10,27,12,79,26,49,18,37,145,32,121,42,6,19,10,41,047,000501,2,410470005012
"Block Group 1, Census Tract 5.01, Marion County, Oregon",428,392,36,428,142,286,428,0,5,50,8,65,0,36,45,27,39,27,66,41,6,13,0,41,047,000501,1,410470005011
"Block Group 2, Census Tract 7.06, Lane County, Oregon",683,278,405,683,108,575,683,9,31,29,21,63,66,30,44,11,33,161,87,45,9,44,0,41,039,000706,2,410390007062
"Block Group 1, Census Tract 18.03, Marion County, Oregon",1000,541,459,1000,302,698,1000,96,85,140,82,67,71,49,98,41,56,59,89,19,33,15,0,41,047,001803,1,410470018031
"Block Group 2, Census Tract 18.03, Marion County, Oregon",107,79,28,107,7,100,107,0,0,0,0,0,0,0,0,0,0,0,21,0,18,22,46,41,047,001803,2,410470018032
"Block Group 2, Census Tract 26, Marion County, Oregon",342,267,75,342,24,318,342,6,6,24,0,22,12,0,0,7,23,42,41,34,26,53,46,41,047,002600,2,410470026002
"Block Group 1, Census Tract 26, Marion County, Oregon",340,278,62,340,21,319,340,17,13,23,0,0,7,0,12,10,16,14,97,44,34,21,32,41,047,002600,1,410470026001
"Block Group 1, Census Tract 242, Clackamas County, Oregon",575,322,253,575,116,459,575,45,34,30,47,57,5,37,4,0,80,67,31,70,44,24,0,41,005,024200,1,410050242001
"Block Group 2, Census Tract 242, Clackamas County, Oregon",1094,911,183,1094,33,1061,1094,15,0,18,51,15,5,0,67,0,115,128,205,261,111,73,30,41,005,024200,2,410050242002
"Block Group 4, Census Tract 242, Clackamas County, Oregon",420,340,80,420,17,403,420,0,44,0,0,52,0,0,34,14,65,54,67,0,36,40,14,41,005,024200,4,410050242004
"Block Group 3, Census Tract 242, Clackamas County, Oregon",407,199,208,407,82,325,407,32,0,16,0,35,45,84,22,0,31,0,87,0,17,38,0,41,005,024200,3,410050242003
"Block Group 1, Census Tract 210, Clackamas County, Oregon",469,403,66,469,62,407,469,20,39,14,6,0,20,0,14,0,105,30,42,87,76,6,10,41,005,021000,1,410050210001
"Block Group 3, Census Tract 210, Clackamas County, Oregon",531,428,103,531,129,402,531,43,38,6,10,0,25,0,10,19,81,41,90,29,57,72,10,41,005,021000,3,410050210003
"Block Group 1, Census Tract 218.01, Clackamas County, Oregon",901,750,151,901,17,884,901,0,0,0,16,61,0,13,30,87,37,67,190,88,163,99,50,41,005,021801,1,410050218011
"Block Group 2, Census Tract 218.01, Clackamas County, Oregon",600,511,89,600,11,589,600,0,0,13,17,14,11,0,0,0,57,81,66,118,56,84,83,41,005,021801,2,410050218012
"Block Group 2, Census Tract 227.02, Clackamas County, Oregon",682,478,204,682,102,580,682,0,15,28,12,0,68,28,0,14,49,17,29,13,88,58,263,41,005,022702,2,410050227022
"Block Group 1, Census Tract 227.02, Clackamas County, Oregon",1131,986,145,1131,9,1122,1131,47,21,0,13,0,0,31,91,0,29,103,87,101,50,364,194,41,005,022702,1,410050227021
"Block Group 2, Census Tract 213, Clackamas County, Oregon",756,598,158,756,16,740,756,0,0,0,25,21,9,39,0,50,27,92,144,105,83,80,81,41,005,021300,2,410050213002
"Block Group 1, Census Tract 213, Clackamas County, Oregon",1290,1015,275,1290,186,1104,1290,39,23,33,98,71,39,60,128,103,81,355,125,32,19,61,23,41,005,021300,1,410050213001
"Block Group 2, Census Tract 204.01, Clackamas County, Oregon",364,322,42,364,33,331,364,0,0,15,28,0,0,0,0,0,37,69,76,51,22,14,52,41,005,020401,2,410050204012
"Block Group 3, Census Tract 204.01, Clackamas County, Oregon",613,427,186,613,34,579,613,29,70,0,15,16,15,13,29,0,13,14,51,45,84,105,114,41,005,020401,3,410050204013
"Block Group 1, Census Tract 3613, Josephine County, Oregon",916,555,361,916,42,874,916,84,0,27,0,62,89,0,23,0,17,73,305,180,38,0,18,41,033,361300,1,410333613001
"Block Group 3, Census Tract 3613, Josephine County, Oregon",540,388,152,540,141,399,540,14,89,0,16,35,15,0,65,0,48,55,39,82,67,0,15,41,033,361300,3,410333613003
"Block Group 2, Census Tract 3614, Josephine County, Oregon",733,461,272,733,145,588,733,127,46,34,57,32,24,41,38,37,31,97,97,22,30,8,12,41,033,361400,2,410333614002
"Block Group 2, Census Tract 3607.01, Josephine County, Oregon",374,321,53,374,88,286,374,12,23,19,22,59,11,10,18,37,61,58,12,32,0,0,0,41,033,360701,2,410333607012
"Block Group 1, Census Tract 3607.01, Josephine County, Oregon",1107,838,269,1107,279,828,1107,98,50,0,36,128,74,140,26,130,123,72,72,133,12,0,13,41,033,360701,1,410333607011
"Block Group 4, Census Tract 3603, Josephine County, Oregon",604,387,217,604,133,471,604,80,35,105,33,51,73,0,31,18,0,72,18,19,0,49,20,41,033,360300,4,410333603004
"Block Group 3, Census Tract 3603, Josephine County, Oregon",742,517,225,742,129,613,742,0,34,23,0,0,157,71,18,61,48,33,117,121,21,18,20,41,033,360300,3,410333603003
"Block Group 2, Census Tract 3604, Josephine County, Oregon",1072,726,346,1072,261,811,1072,65,28,85,74,41,34,52,50,20,37,182,161,80,42,3,118,41,033,360400,2,410333604002
"Block Group 1, Census Tract 3612, Josephine County, Oregon",1123,789,334,1123,655,468,1123,228,112,128,139,18,100,72,23,0,105,117,36,0,0,15,30,41,033,361200,1,410333612001
"Block Group 3, Census Tract 3612, Josephine County, Oregon",803,562,241,803,222,581,803,49,0,22,115,33,29,110,67,29,82,86,26,91,33,31,0,41,033,361200,3,410333612003
"Block Group 1, Census Tract 3601, Josephine County, Oregon",523,259,264,523,218,305,523,86,23,36,36,28,95,62,7,0,14,12,63,32,0,0,29,41,033,360100,1,410333601001
"Block Group 2, Census Tract 3601, Josephine County, Oregon",321,154,167,321,56,265,321,6,12,29,33,22,21,10,13,8,20,59,28,19,2,39,0,41,033,360100,2,410333601002
"Block Group 1, Census Tract 3609, Josephine County, Oregon",810,361,449,810,163,647,810,12,74,43,64,68,63,8,76,56,55,103,74,58,24,32,0,41,033,360900,1,410333609001
"Block Group 2, Census Tract 3606, Josephine County, Oregon",815,540,275,815,105,710,815,17,23,34,25,41,36,39,65,90,88,92,96,36,50,48,35,41,033,360600,2,410333606002
"Block Group 3, Census Tract 3606, Josephine County, Oregon",307,199,108,307,21,286,307,0,0,29,36,16,18,17,18,16,38,26,44,17,11,21,0,41,033,360600,3,410333606003
"Block Group 1, Census Tract 3606, Josephine County, Oregon",659,428,231,659,130,529,659,117,77,38,19,12,0,24,59,19,12,79,61,57,0,53,32,41,033,360600,1,410333606001
"Block Group 5, Census Tract 27, Marion County, Oregon",750,553,197,750,53,697,750,14,0,17,0,0,0,12,58,45,81,20,76,63,70,226,68,41,047,002700,5,410470027005
"Block Group 2, Census Tract 12.02, Multnomah County, Oregon",569,517,52,569,0,569,569,24,10,24,0,0,9,13,0,25,39,97,56,31,40,83,118,41,051,001202,2,410510012022
"Block Group 1, Census Tract 12.02, Multnomah County, Oregon",565,460,105,565,21,544,565,20,11,44,9,22,12,10,0,9,28,40,35,23,67,131,104,41,051,001202,1,410510012021
"Block Group 3, Census Tract 6.02, Jackson County, Oregon",787,290,497,787,40,747,787,13,0,15,0,0,40,26,25,0,97,54,128,93,53,71,172,41,029,000602,3,410290006023
"Block Group 1, Census Tract 103.07, Marion County, Oregon",1430,885,545,1430,88,1342,1430,11,46,16,33,63,89,83,46,145,61,217,175,177,115,99,54,41,047,010307,1,410470103071
"Block Group 2, Census Tract 103.07, Marion County, Oregon",399,333,66,399,103,296,399,26,0,12,62,0,27,0,16,66,75,38,32,16,29,0,0,41,047,010307,2,410470103072
"Block Group 1, Census Tract 102.01, Marion County, Oregon",567,395,172,567,19,548,567,10,20,0,14,36,11,0,11,21,34,90,74,68,93,10,75,41,047,010201,1,410470102011
"Block Group 2, Census Tract 102.01, Marion County, Oregon",519,421,98,519,41,478,519,9,8,3,30,2,9,0,46,42,37,93,98,53,36,41,12,41,047,010201,2,410470102012
"Block Group 2, Census Tract 22.01, Marion County, Oregon",257,195,62,257,13,244,257,2,6,0,0,0,22,0,0,11,6,62,71,46,16,8,7,41,047,002201,2,410470022012
"Block Group 3, Census Tract 1300, Douglas County, Oregon",462,303,159,462,86,376,462,0,29,77,41,0,36,0,25,63,18,54,69,0,19,13,18,41,019,130000,3,410191300003
"Block Group 2, Census Tract 1700, Douglas County, Oregon",940,743,197,940,116,824,940,22,17,50,44,21,6,25,23,60,192,142,110,102,74,28,24,41,019,170000,2,410191700002
"Block Group 1, Census Tract 1700, Douglas County, Oregon",402,267,135,402,42,360,402,0,0,53,10,15,27,21,15,36,86,36,19,11,65,0,8,41,019,170000,1,410191700001
"Block Group 1, Census Tract 300, Douglas County, Oregon",355,241,114,355,60,295,355,30,0,17,9,15,37,36,48,21,32,14,34,28,17,6,11,41,019,030000,1,410190300001
"Block Group 2, Census Tract 300, Douglas County, Oregon",547,325,222,547,74,473,547,29,39,25,16,35,30,51,43,61,18,30,71,37,32,15,15,41,019,030000,2,410190300002
"Block Group 3, Census Tract 300, Douglas County, Oregon",638,421,217,638,109,529,638,27,7,27,80,29,29,46,23,17,94,92,81,39,15,17,15,41,019,030000,3,410190300003
"Block Group 1, Census Tract 600, Douglas County, Oregon",364,254,110,364,55,309,364,31,0,0,22,24,0,7,19,17,29,47,25,33,37,49,24,41,019,060000,1,410190600001
"Block Group 3, Census Tract 330, Washington County, Oregon",551,485,66,551,14,537,551,0,13,0,14,0,13,0,31,12,43,69,127,42,34,29,124,41,067,033000,3,410670330003
"Block Group 4, Census Tract 330, Washington County, Oregon",612,460,152,612,42,570,612,35,6,4,18,4,0,0,29,9,61,44,165,68,24,77,68,41,067,033000,4,410670330004
"Block Group 2, Census Tract 330, Washington County, Oregon",508,391,117,508,99,409,508,47,21,35,6,5,6,63,6,27,34,58,48,62,42,46,2,41,067,033000,2,410670330002
"Block Group 1, Census Tract 330, Washington County, Oregon",371,268,103,371,28,343,371,16,28,0,0,0,26,46,32,0,12,23,38,16,103,13,18,41,067,033000,1,410670330001
"Block Group 2, Census Tract 336, Washington County, Oregon",240,146,94,240,15,225,240,8,0,0,24,0,6,0,17,13,21,21,36,31,14,34,15,41,067,033600,2,410670336002
"Block Group 3, Census Tract 336, Washington County, Oregon",313,257,56,313,49,264,313,3,0,6,0,27,8,0,32,22,23,37,43,45,26,12,29,41,067,033600,3,410670336003
"Block Group 1, Census Tract 336, Washington County, Oregon",288,217,71,288,28,260,288,0,9,23,0,8,18,0,4,20,28,20,57,32,27,32,10,41,067,033600,1,410670336001
"Block Group 4, Census Tract 310.05, Washington County, Oregon",427,358,69,427,86,341,427,42,0,30,0,18,65,47,0,54,36,11,28,49,0,47,0,41,067,031005,4,410670310054
"Block Group 1, Census Tract 310.05, Washington County, Oregon",443,376,67,443,10,433,443,16,41,0,0,14,31,35,20,16,46,61,31,79,14,28,11,41,067,031005,1,410670310051
"Block Group 2, Census Tract 9515, Lincoln County, Oregon",926,521,405,926,166,760,926,55,26,59,68,35,47,79,27,65,109,67,109,79,46,42,13,41,041,951500,2,410419515002
"Block Group 2, Census Tract 9513, Lincoln County, Oregon",556,431,125,556,55,501,556,48,11,48,26,17,54,9,27,46,27,104,47,28,0,24,40,41,041,951300,2,410419513002
"Block Group 2, Census Tract 5, Benton County, Oregon",537,431,106,537,49,488,537,0,8,9,9,0,6,17,35,14,19,16,68,16,83,92,145,41,003,000500,2,410030005002
"Block Group 1, Census Tract 5, Benton County, Oregon",439,263,176,439,12,427,439,24,20,29,0,0,0,10,22,11,69,33,56,70,46,30,19,41,003,000500,1,410030005001
"Block Group 3, Census Tract 9, Benton County, Oregon",1115,823,292,1115,209,906,1115,124,82,46,28,36,0,7,141,45,42,87,77,119,136,74,71,41,003,000900,3,410030009003
"Block Group 4, Census Tract 9, Benton County, Oregon",451,299,152,451,0,451,451,31,16,0,0,0,0,0,0,35,15,13,37,22,45,68,169,41,003,000900,4,410030009004
"Block Group 5, Census Tract 9, Benton County, Oregon",317,220,97,317,0,317,317,23,0,17,0,0,0,0,0,74,16,0,76,80,24,0,7,41,003,000900,5,410030009005
"Block Group 3, Census Tract 10.02, Benton County, Oregon",414,326,88,414,22,392,414,0,0,0,16,25,16,9,12,18,7,34,97,127,18,17,18,41,003,001002,3,410030010023
"Block Group 1, Census Tract 10.02, Benton County, Oregon",300,230,70,300,28,272,300,42,12,34,0,35,0,7,5,0,8,63,28,24,20,7,15,41,003,001002,1,410030010021
"Block Group 2, Census Tract 32.02, Lane County, Oregon",493,351,142,493,81,412,493,64,32,0,12,27,29,33,0,34,18,39,97,55,22,12,19,41,039,003202,2,410390032022
"Block Group 1, Census Tract 25.01, Lane County, Oregon",458,358,100,458,121,337,458,16,17,22,0,17,29,37,22,21,54,26,113,71,0,13,0,41,039,002501,1,410390025011
"Block Group 3, Census Tract 25.01, Lane County, Oregon",599,442,157,599,159,440,599,43,17,0,13,8,27,58,8,32,30,155,93,86,29,0,0,41,039,002501,3,410390025013
"Block Group 2, Census Tract 27, Lane County, Oregon",705,560,145,705,221,484,705,89,25,40,85,10,36,9,45,53,29,86,105,70,16,7,0,41,039,002700,2,410390027002
"Block Group 2, Census Tract 32.01, Lane County, Oregon",1001,733,268,1001,316,685,1001,60,35,125,39,90,11,60,40,33,155,65,219,54,0,0,15,41,039,003201,2,410390032012
"Block Group 2, Census Tract 12.02, Lane County, Oregon",497,267,230,497,112,385,497,92,8,23,36,10,9,31,0,49,63,37,90,34,0,15,0,41,039,001202,2,410390012022
"Block Group 1, Census Tract 7.06, Lane County, Oregon",529,371,158,529,54,475,529,0,10,45,10,74,19,62,20,11,71,47,29,45,29,0,57,41,039,000706,1,410390007061
"Block Group 3, Census Tract 9506.01, Lincoln County, Oregon",498,274,224,498,96,402,498,29,27,26,47,36,0,56,0,9,53,55,107,33,0,0,20,41,041,950601,3,410419506013
"Block Group 2, Census Tract 9506.01, Lincoln County, Oregon",542,228,314,542,35,507,542,0,8,19,47,26,30,47,61,27,80,52,58,29,37,0,21,41,041,950601,2,410419506012
"Block Group 3, Census Tract 5.04, Coos County, Oregon",342,234,108,342,78,264,342,35,51,0,0,19,0,71,48,0,69,14,16,10,9,0,0,41,011,000504,3,410110005043
"Block Group 2, Census Tract 5.04, Coos County, Oregon",607,172,435,607,95,512,607,0,71,98,75,51,42,34,2,14,55,62,72,15,0,0,16,41,011,000504,2,410110005042
"Block Group 5, Census Tract 5.04, Coos County, Oregon",986,751,235,986,379,607,986,165,23,108,70,68,53,33,58,32,57,73,104,58,59,22,3,41,011,000504,5,410110005045
"Block Group 1, Census Tract 5.03, Coos County, Oregon",551,459,92,551,95,456,551,10,28,9,0,0,22,60,0,23,86,55,114,72,11,30,31,41,011,000503,1,410110005031
"Block Group 3, Census Tract 33.01, Lane County, Oregon",364,335,29,364,119,245,364,23,7,0,17,17,87,42,11,20,75,21,8,31,0,5,0,41,039,003301,3,410390033013
"Block Group 2, Census Tract 33.01, Lane County, Oregon",408,325,83,408,81,327,408,34,25,23,12,13,111,7,22,20,27,24,55,24,5,0,6,41,039,003301,2,410390033012
"Block Group 2, Census Tract 5.03, Coos County, Oregon",511,314,197,511,162,349,511,58,20,10,0,55,10,33,40,21,98,51,77,28,10,0,0,41,011,000503,2,410110005032
"Block Group 1, Census Tract 229.07, Clackamas County, Oregon",798,646,152,798,97,701,798,12,52,10,24,10,53,9,19,39,83,71,121,127,88,45,35,41,005,022907,1,410050229071
"Block Group 2, Census Tract 9506.02, Lincoln County, Oregon",810,479,331,810,79,731,810,36,84,4,17,21,62,27,60,70,49,77,104,54,38,63,44,41,041,950602,2,410419506022
"Block Group 0, Census Tract 9901, Lincoln County, Oregon",0,0,0,0,0,0,0,0,0,0,0,0,0,0,0,0,0,0,0,0,0,0,0,41,041,990100,0,410419901000
"Block Group 1, Census Tract 9503.04, Lincoln County, Oregon",486,328,158,486,63,423,486,28,14,50,53,54,23,13,36,50,49,40,30,24,22,0,0,41,041,950304,1,410419503041
"Block Group 1, Census Tract 227.07, Clackamas County, Oregon",452,353,99,452,0,452,452,15,15,0,20,55,0,0,27,10,16,39,36,39,55,41,84,41,005,022707,1,410050227071
"Block Group 2, Census Tract 229.06, Clackamas County, Oregon",514,466,48,514,43,471,514,23,0,0,0,10,25,14,10,9,72,95,100,87,10,28,31,41,005,022906,2,410050229062
"Block Group 2, Census Tract 319.09, Washington County, Oregon",706,690,16,706,47,659,706,0,0,0,0,35,0,38,9,23,39,27,43,120,101,146,125,41,067,031909,2,410670319092
"Block Group 1, Census Tract 318.12, Washington County, Oregon",1020,894,126,1020,35,985,1020,67,12,0,0,40,15,17,57,31,52,69,249,48,40,239,84,41,067,031812,1,410670318121
"Block Group 2, Census Tract 318.12, Washington County, Oregon",1643,1392,251,1643,119,1524,1643,192,13,47,45,120,34,43,61,181,187,139,251,79,145,62,44,41,067,031812,2,410670318122
"Block Group 4, Census Tract 70, Multnomah County, Oregon",1739,1505,234,1739,76,1663,1739,46,21,14,83,0,0,36,18,12,52,132,191,97,199,191,647,41,051,007000,4,410510070004
"Block Group 4, Census Tract 305.01, Yamhill County, Oregon",43,21,22,43,0,43,43,0,0,0,0,0,0,32,0,11,0,0,0,0,0,0,0,41,071,030501,4,410710305014
"Block Group 2, Census Tract 324.09, Washington County, Oregon",859,714,145,859,392,467,859,19,44,19,172,10,66,97,9,0,76,124,104,62,29,18,10,41,067,032409,2,410670324092
"Block Group 1, Census Tract 333.02, Washington County, Oregon",715,600,115,715,6,709,715,0,0,0,9,9,0,36,25,6,30,131,115,86,105,81,82,41,067,033302,1,410670333021
"Block Group 0, Census Tract 9901.01, Curry County, Oregon",0,0,0,0,0,0,0,0,0,0,0,0,0,0,0,0,0,0,0,0,0,0,0,41,015,990101,0,410159901010
"Block Group 0, Census Tract 9901, Tillamook County, Oregon",0,0,0,0,0,0,0,0,0,0,0,0,0,0,0,0,0,0,0,0,0,0,0,41,057,990100,0,410579901000
"Block Group 3, Census Tract 333.01, Washington County, Oregon",339,291,48,339,122,217,339,20,32,11,10,22,9,0,43,10,43,38,65,8,8,20,0,41,067,033301,3,410670333013
"Block Group 2, Census Tract 333.01, Washington County, Oregon",245,206,39,245,21,224,245,12,10,0,11,13,0,0,72,13,10,51,12,16,0,25,0,41,067,033301,2,410670333012
"Block Group 3, Census Tract 318.15, Washington County, Oregon",417,303,114,417,17,400,417,0,12,51,0,17,31,24,16,0,31,0,97,14,36,52,36,41,067,031815,3,410670318153
"Block Group 2, Census Tract 6.02, Jackson County, Oregon",1122,576,546,1122,92,1030,1122,81,142,39,46,145,52,70,91,25,88,118,81,63,27,41,13,41,029,000602,2,410290006022
"Block Group 1, Census Tract 325.03, Washington County, Oregon",843,721,122,843,41,802,843,12,0,16,15,10,17,55,10,23,55,91,116,106,123,141,53,41,067,032503,1,410670325031
"Block Group 4, Census Tract 302, Washington County, Oregon",580,505,75,580,60,520,580,0,0,19,9,45,17,25,29,0,17,19,44,62,52,143,99,41,067,030200,4,410670302004
"Block Group 4, Census Tract 104.05, Multnomah County, Oregon",669,496,173,669,43,626,669,16,69,112,92,14,0,46,50,0,68,80,80,0,33,9,0,41,051,010405,4,410510104054
"Block Group 2, Census Tract 64.04, Multnomah County, Oregon",938,727,211,938,65,873,938,58,48,8,27,8,20,24,38,8,50,92,146,140,76,71,124,41,051,006404,2,410510064042
"Block Group 1, Census Tract 64.04, Multnomah County, Oregon",858,664,194,858,60,798,858,21,17,14,32,25,9,35,64,60,69,77,58,115,44,77,141,41,051,006404,1,410510064041
"Block Group 1, Census Tract 99.05, Multnomah County, Oregon",479,413,66,479,27,452,479,0,0,0,8,17,0,12,16,32,78,10,153,65,33,47,8,41,051,009905,1,410510099051
"Block Group 2, Census Tract 99.05, Multnomah County, Oregon",716,591,125,716,104,612,716,18,9,22,26,30,18,18,47,34,17,86,167,114,30,62,18,41,051,009905,2,410510099052
"Block Group 2, Census Tract 99.07, Multnomah County, Oregon",471,418,53,471,109,362,471,24,56,0,9,12,29,54,17,47,39,26,73,21,14,50,0,41,051,009907,2,410510099072
"Block Group 1, Census Tract 99.07, Multnomah County, Oregon",317,258,59,317,60,257,317,25,8,0,15,8,9,17,21,42,44,55,50,13,0,0,10,41,051,009907,1,410510099071
"Block Group 3, Census Tract 99.07, Multnomah County, Oregon",1207,897,310,1207,100,1107,1207,68,29,8,10,26,32,41,35,8,80,100,134,134,160,130,212,41,051,009907,3,410510099073
"Block Group 2, Census Tract 104.11, Multnomah County, Oregon",723,550,173,723,152,571,723,51,27,21,19,27,9,26,36,35,92,87,149,100,14,16,14,41,051,010411,2,410510104112
"Block Group 2, Census Tract 315.13, Washington County, Oregon",1275,922,353,1275,132,1143,1275,28,23,17,22,126,20,19,91,32,59,43,134,169,113,130,249,41,067,031513,2,410670315132
"Block Group 3, Census Tract 315.13, Washington County, Oregon",1723,1646,77,1723,78,1645,1723,0,70,0,0,60,0,21,14,0,32,121,118,115,110,451,611,41,067,031513,3,410670315133
"Block Group 4, Census Tract 301.01, Washington County, Oregon",961,869,92,961,35,926,961,50,0,44,46,33,10,31,16,19,60,63,227,125,19,120,98,41,067,030101,4,410670301014
"Block Group 1, Census Tract 301.01, Washington County, Oregon",488,403,85,488,0,488,488,0,0,0,13,14,0,24,0,10,0,0,84,92,49,111,91,41,067,030101,1,410670301011
"Block Group 3, Census Tract 301.01, Washington County, Oregon",2101,1710,391,2101,46,2055,2101,70,55,9,68,67,71,54,131,126,150,119,305,253,297,168,158,41,067,030101,3,410670301013
"Block Group 1, Census Tract 301.02, Washington County, Oregon",1556,1393,163,1556,83,1473,1556,72,12,14,14,9,54,104,11,53,92,241,236,235,111,220,78,41,067,030102,1,410670301021
"Block Group 2, Census Tract 316.15, Washington County, Oregon",446,413,33,446,33,413,446,0,0,0,0,28,7,0,7,0,45,49,128,123,9,39,11,41,067,031615,2,410670316152
"Block Group 4, Census Tract 316.15, Washington County, Oregon",248,201,47,248,11,237,248,23,0,8,0,11,10,11,30,11,21,0,27,28,47,21,0,41,067,031615,4,410670316154
"Block Group 1, Census Tract 316.15, Washington County, Oregon",521,430,91,521,160,361,521,46,102,17,38,11,44,7,8,0,50,102,26,59,11,0,0,41,067,031615,1,410670316151
"Block Group 1, Census Tract 324.08, Washington County, Oregon",932,850,82,932,70,862,932,51,16,16,0,34,0,14,0,73,28,47,149,117,42,165,180,41,067,032408,1,410670324081
"Block Group 1, Census Tract 326.08, Washington County, Oregon",990,818,172,990,39,951,990,41,8,13,29,7,24,46,12,11,45,102,129,217,92,133,81,41,067,032608,1,410670326081
"Block Group 2, Census Tract 326.10, Washington County, Oregon",305,249,56,305,35,270,305,25,0,11,11,6,0,18,31,20,17,34,42,29,33,17,11,41,067,032610,2,410670326102
"Block Group 1, Census Tract 321.07, Washington County, Oregon",769,638,131,769,4,765,769,16,5,11,22,0,13,26,23,16,20,65,168,118,72,93,101,41,067,032107,1,410670321071
"Block Group 2, Census Tract 321.04, Washington County, Oregon",818,700,118,818,67,751,818,51,19,28,8,10,28,45,37,17,53,53,103,81,137,83,65,41,067,032104,2,410670321042
"Block Group 3, Census Tract 326.06, Washington County, Oregon",315,264,51,315,27,288,315,13,0,13,0,13,0,0,0,47,12,0,78,60,11,57,11,41,067,032606,3,410670326063
"Block Group 5, Census Tract 326.06, Washington County, Oregon",312,216,96,312,38,274,312,0,0,0,13,12,0,31,22,0,0,38,26,73,12,52,33,41,067,032606,5,410670326065
"Block Group 4, Census Tract 326.06, Washington County, Oregon",427,338,89,427,50,377,427,0,25,0,0,0,44,0,0,12,0,15,61,211,20,26,13,41,067,032606,4,410670326064
"Block Group 3, Census Tract 9501, Clatsop County, Oregon",660,494,166,660,108,552,660,29,61,28,37,31,39,49,28,40,77,53,68,89,0,14,17,41,007,950100,3,410079501003
"Block Group 1, Census Tract 9501, Clatsop County, Oregon",322,241,81,322,64,258,322,42,11,0,30,0,34,31,39,32,10,28,16,16,9,24,0,41,007,950100,1,410079501001
"Block Group 1, Census Tract 9507, Clatsop County, Oregon",497,358,139,497,59,438,497,50,24,6,12,43,44,17,16,12,31,49,49,98,14,14,18,41,007,950700,1,410079507001
"Block Group 3, Census Tract 9504, Clatsop County, Oregon",307,279,28,307,29,278,307,0,0,0,0,7,14,16,38,11,34,7,68,88,0,0,24,41,007,950400,3,410079504003
"Block Group 1, Census Tract 9504, Clatsop County, Oregon",441,292,149,441,48,393,441,10,9,10,0,0,0,9,29,21,95,40,66,21,78,47,6,41,007,950400,1,410079504001
"Block Group 1, Census Tract 9511, Clatsop County, Oregon",773,489,284,773,161,612,773,89,17,77,13,51,31,90,16,16,91,52,42,79,0,109,0,41,007,951100,1,410079511001
"Block Group 3, Census Tract 9511, Clatsop County, Oregon",378,234,144,378,67,311,378,33,70,0,28,47,12,0,15,0,51,52,50,9,0,0,11,41,007,951100,3,410079511003
"Block Group 2, Census Tract 2, Coos County, Oregon",550,399,151,550,156,394,550,28,29,0,26,23,0,39,22,15,48,68,134,73,5,35,5,41,011,000200,2,410110002002
"Block Group 1, Census Tract 2, Coos County, Oregon",304,211,93,304,37,267,304,10,0,0,12,15,15,0,19,0,39,8,74,31,54,0,27,41,011,000200,1,410110002001
"Block Group 5, Census Tract 306, Linn County, Oregon",518,456,62,518,126,392,518,27,17,45,0,20,17,46,89,0,0,45,150,41,21,0,0,41,043,030600,5,410430306005
"Block Group 1, Census Tract 202, Linn County, Oregon",864,737,127,864,131,733,864,60,24,14,69,45,84,30,14,38,65,143,63,74,44,60,37,41,043,020200,1,410430202001
"Block Group 1, Census Tract 205, Linn County, Oregon",619,504,115,619,103,516,619,27,23,0,111,14,50,42,76,23,47,55,94,11,20,18,8,41,043,020500,1,410430205001
"Block Group 2, Census Tract 205, Linn County, Oregon",1094,677,417,1094,215,879,1094,34,126,29,96,48,73,90,45,37,149,74,109,85,70,21,8,41,043,020500,2,410430205002
"Block Group 4, Census Tract 2100, Douglas County, Oregon",633,379,254,633,82,551,633,109,37,26,52,12,33,54,31,42,25,71,30,29,61,21,0,41,019,210000,4,410192100004
"Block Group 2, Census Tract 2100, Douglas County, Oregon",383,195,188,383,128,255,383,13,41,3,14,51,51,61,17,20,17,22,18,17,29,9,0,41,019,210000,2,410192100002
"Block Group 5, Census Tract 2100, Douglas County, Oregon",320,215,105,320,103,217,320,27,9,43,8,24,56,5,42,34,13,7,30,13,0,9,0,41,019,210000,5,410192100005
"Block Group 3, Census Tract 2100, Douglas County, Oregon",302,219,83,302,94,208,302,47,31,32,45,19,8,22,0,15,2,39,23,0,12,7,0,41,019,210000,3,410192100003
"Block Group 2, Census Tract 100, Douglas County, Oregon",647,345,302,647,200,447,647,33,69,70,65,39,43,56,46,14,79,47,51,19,8,8,0,41,019,010000,2,410190100002
"Block Group 1, Census Tract 100, Douglas County, Oregon",473,375,98,473,86,387,473,8,8,29,19,79,12,17,48,13,125,46,28,36,5,0,0,41,019,010000,1,410190100001
"Block Group 2, Census Tract 400, Douglas County, Oregon",572,311,261,572,189,383,572,52,7,14,73,19,14,27,83,11,63,91,71,38,9,0,0,41,019,040000,2,410190400002
"Block Group 3, Census Tract 400, Douglas County, Oregon",304,178,126,304,73,231,304,0,27,11,18,17,67,6,17,17,20,26,24,36,4,0,14,41,019,040000,3,410190400003
"Block Group 1, Census Tract 400, Douglas County, Oregon",300,142,158,300,10,290,300,2,11,18,5,27,16,20,16,16,15,60,52,31,0,11,0,41,019,040000,1,410190400001
"Block Group 1, Census Tract 500.02, Douglas County, Oregon",1248,728,520,1248,353,895,1248,191,57,40,125,21,121,36,50,31,132,105,191,120,8,20,0,41,019,050002,1,410190500021
"Block Group 4, Census Tract 500.02, Douglas County, Oregon",574,344,230,574,114,460,574,49,0,19,58,91,56,0,30,47,43,70,59,35,0,0,17,41,019,050002,4,410190500024
"Block Group 2, Census Tract 1000, Douglas County, Oregon",457,332,125,457,109,348,457,0,10,28,78,40,17,0,27,45,12,91,42,9,10,16,32,41,019,100000,2,410191000002
"Block Group 3, Census Tract 1000, Douglas County, Oregon",431,345,86,431,53,378,431,11,20,0,44,51,58,12,40,18,12,25,21,55,12,52,0,41,019,100000,3,410191000003
"Block Group 4, Census Tract 1200, Douglas County, Oregon",446,216,230,446,148,298,446,33,20,22,65,18,13,50,11,68,23,60,47,16,0,0,0,41,019,120000,4,410191200004
"Block Group 5, Census Tract 1200, Douglas County, Oregon",262,137,125,262,46,216,262,15,32,0,0,15,13,58,16,34,19,17,13,30,0,0,0,41,019,120000,5,410191200005
"Block Group 1, Census Tract 1200, Douglas County, Oregon",1032,633,399,1032,238,794,1032,16,72,49,30,74,76,81,66,17,88,221,163,33,36,10,0,41,019,120000,1,410191200001
"Block Group 2, Census Tract 1200, Douglas County, Oregon",909,667,242,909,377,532,909,82,83,107,134,66,24,37,116,84,10,105,30,31,0,0,0,41,019,120000,2,410191200002
"Block Group 1, Census Tract 900, Douglas County, Oregon",413,228,185,413,83,330,413,35,0,31,0,57,46,0,11,0,0,15,102,9,36,51,20,41,019,090000,1,410190900001
"Block Group 2, Census Tract 900, Douglas County, Oregon",367,120,247,367,116,251,367,0,37,30,50,90,41,59,34,0,13,0,13,0,0,0,0,41,019,090000,2,410190900002
"Block Group 2, Census Tract 309.02, Linn County, Oregon",636,352,284,636,144,492,636,6,35,63,57,5,36,44,49,59,4,32,131,33,36,16,30,41,043,030902,2,410430309022
"Block Group 3, Census Tract 309.02, Linn County, Oregon",569,381,188,569,111,458,569,15,2,53,22,15,20,16,27,20,22,72,160,32,56,18,19,41,043,030902,3,410430309023
"Block Group 5, Census Tract 309.02, Linn County, Oregon",881,719,162,881,124,757,881,34,16,62,34,79,72,30,31,30,232,74,31,94,45,17,0,41,043,030902,5,410430309025
"Block Group 3, Census Tract 309.03, Linn County, Oregon",913,589,324,913,201,712,913,39,70,73,68,76,76,33,20,58,61,4,151,53,81,26,24,41,043,030903,3,410430309033
"Block Group 1, Census Tract 309.03, Linn County, Oregon",485,238,247,485,208,277,485,88,69,0,15,43,39,45,0,0,32,70,67,0,5,12,0,41,043,030903,1,410430309031
"Block Group 1, Census Tract 309.04, Linn County, Oregon",375,251,124,375,101,274,375,51,9,0,8,16,34,12,0,0,32,64,88,29,0,18,14,41,043,030904,1,410430309041
"Block Group 3, Census Tract 309.04, Linn County, Oregon",556,373,183,556,92,464,556,47,7,15,14,23,16,28,41,0,30,91,60,41,69,50,24,41,043,030904,3,410430309043
"Block Group 3, Census Tract 12.02, Lane County, Oregon",549,419,130,549,216,333,549,41,51,26,7,38,119,40,58,9,49,18,28,25,31,9,0,41,039,001202,3,410390012023
"Block Group 4, Census Tract 15, Lane County, Oregon",518,257,261,518,256,262,518,22,12,0,84,74,113,20,55,0,85,0,53,0,0,0,0,41,039,001500,4,410390015004
"Block Group 1, Census Tract 15, Lane County, Oregon",445,213,232,445,69,376,445,12,18,21,63,4,8,33,34,19,13,85,71,8,20,36,0,41,039,001500,1,410390015001
"Block Group 2, Census Tract 15, Lane County, Oregon",640,390,250,640,262,378,640,23,119,62,0,147,34,71,23,0,93,37,31,0,0,0,0,41,039,001500,2,410390015002
"Block Group 1, Census Tract 18.01, Lane County, Oregon",712,579,133,712,144,568,712,13,5,59,20,7,60,0,20,30,57,72,91,69,85,61,63,41,039,001801,1,410390018011
"Block Group 1, Census Tract 54, Lane County, Oregon",543,409,134,543,17,526,543,0,0,0,11,47,27,0,11,33,89,65,104,62,47,31,16,41,039,005400,1,410390054001
"Block Group 2, Census Tract 43, Lane County, Oregon",632,486,146,632,125,507,632,72,0,34,0,154,15,40,40,10,65,68,19,77,38,0,0,41,039,004300,2,410390043002
"Block Group 4, Census Tract 43, Lane County, Oregon",603,496,107,603,174,429,603,27,26,28,0,15,80,20,13,26,59,113,38,83,32,43,0,41,039,004300,4,410390043004
"Block Group 1, Census Tract 43, Lane County, Oregon",1146,542,604,1146,479,667,1146,144,102,208,76,131,122,0,29,43,16,116,115,34,10,0,0,41,039,004300,1,410390043001
"Block Group 2, Census Tract 38.01, Multnomah County, Oregon",232,174,58,232,33,199,232,0,17,8,0,8,7,0,12,18,0,45,33,19,17,16,32,41,051,003801,2,410510038012
"Block Group 1, Census Tract 42, Multnomah County, Oregon",653,572,81,653,132,521,653,7,0,18,29,0,39,29,28,9,32,51,150,85,53,72,51,41,051,004200,1,410510042001
"Block Group 3, Census Tract 9703, Wasco County, Oregon",475,306,169,475,89,386,475,14,21,0,50,24,17,56,29,63,62,21,91,8,0,19,0,41,065,970300,3,410659703003
"Block Group 2, Census Tract 9701, Wasco County, Oregon",429,330,99,429,50,379,429,0,0,28,92,15,6,11,6,16,59,60,43,56,8,29,0,41,065,970100,2,410659701002
"Block Group 1, Census Tract 9701, Wasco County, Oregon",879,625,254,879,149,730,879,28,58,19,76,19,36,41,83,33,107,106,151,31,24,32,35,41,065,970100,1,410659701001
"Block Group 3, Census Tract 9701, Wasco County, Oregon",307,244,63,307,19,288,307,11,8,7,0,17,8,10,0,0,8,39,130,41,8,20,0,41,065,970100,3,410659701003
"Block Group 1, Census Tract 9708, Wasco County, Oregon",600,439,161,600,54,546,600,21,19,38,21,20,16,23,40,30,40,58,83,90,35,51,15,41,065,970800,1,410659708001
"Block Group 4, Census Tract 9708, Wasco County, Oregon",636,363,273,636,100,536,636,39,13,53,24,42,32,27,66,31,78,53,71,31,44,14,18,41,065,970800,4,410659708004
"Block Group 3, Census Tract 9708, Wasco County, Oregon",170,137,33,170,68,102,170,9,13,3,9,12,11,7,8,13,13,21,13,7,17,14,0,41,065,970800,3,410659708003
"Block Group 2, Census Tract 9708, Wasco County, Oregon",328,237,91,328,78,250,328,12,11,16,20,11,28,42,13,39,47,51,17,13,0,2,6,41,065,970800,2,410659708002
"Block Group 1, Census Tract 329.01, Washington County, Oregon",1094,1023,71,1094,99,995,1094,0,20,0,10,20,8,51,52,47,135,138,151,182,129,109,42,41,067,032901,1,410670329011
"Block Group 1, Census Tract 4.02, Lane County, Oregon",528,421,107,528,53,475,528,30,9,7,16,0,6,64,57,48,37,39,89,57,36,20,13,41,039,000402,1,410390004021
"Block Group 3, Census Tract 4.02, Lane County, Oregon",554,368,186,554,110,444,554,44,40,23,56,8,43,41,0,0,8,49,88,62,29,41,22,41,039,000402,3,410390004023
"Block Group 2, Census Tract 4.02, Lane County, Oregon",288,153,135,288,35,253,288,0,0,0,7,48,0,0,41,10,52,40,27,11,11,7,34,41,039,000402,2,410390004022
"Block Group 1, Census Tract 44.01, Lane County, Oregon",908,778,130,908,284,624,908,0,105,0,77,80,108,14,60,120,76,98,75,68,27,0,0,41,039,004401,1,410390044011
"Block Group 2, Census Tract 2, Lane County, Oregon",539,381,158,539,58,481,539,6,4,31,3,10,13,22,24,11,16,57,168,80,22,55,17,41,039,000200,2,410390002002
"Block Group 4, Census Tract 2, Lane County, Oregon",573,428,145,573,20,553,573,2,0,5,13,14,8,18,10,24,17,106,63,30,92,153,18,41,039,000200,4,410390002004
"Block Group 1, Census Tract 26, Lane County, Oregon",1087,894,193,1087,93,994,1087,16,6,75,0,77,60,93,47,83,125,248,107,83,46,21,0,41,039,002600,1,410390026001
"Block Group 3, Census Tract 26, Lane County, Oregon",807,564,243,807,218,589,807,0,49,48,41,77,44,74,39,74,20,113,177,51,0,0,0,41,039,002600,3,410390026003
"Block Group 4, Census Tract 4.03, Lane County, Oregon",536,395,141,536,34,502,536,65,16,78,14,35,0,56,15,0,19,0,102,110,26,0,0,41,039,000403,4,410390004034
"Block Group 1, Census Tract 4.03, Lane County, Oregon",274,194,80,274,11,263,274,69,0,0,0,0,0,19,71,0,12,9,20,0,74,0,0,41,039,000403,1,410390004031
"Block Group 3, Census Tract 4.03, Lane County, Oregon",685,512,173,685,108,577,685,90,0,46,16,0,58,69,21,104,92,32,83,49,14,11,0,41,039,000403,3,410390004033
"Block Group 1, Census Tract 9.04, Lane County, Oregon",374,264,110,374,52,322,374,16,20,32,28,10,15,14,0,45,50,27,54,16,31,7,9,41,039,000904,1,410390009041
"Block Group 2, Census Tract 20.02, Lane County, Oregon",1039,819,220,1039,452,587,1039,45,97,29,37,12,22,91,14,14,129,287,133,78,36,15,0,41,039,002002,2,410390020022
"Block Group 4, Census Tract 9703, Malheur County, Oregon",467,272,195,467,221,246,467,51,110,58,18,38,18,0,36,4,7,49,24,32,15,0,7,41,045,970300,4,410459703004
"Block Group 1, Census Tract 67.01, Multnomah County, Oregon",696,608,88,696,7,689,696,16,0,9,7,16,17,8,9,20,7,54,83,85,150,123,92,41,051,006701,1,410510067011
"Block Group 1, Census Tract 80.02, Multnomah County, Oregon",582,459,123,582,104,478,582,34,16,42,26,9,0,0,22,27,37,85,84,57,104,31,8,41,051,008002,1,410510080021
"Block Group 2, Census Tract 80.02, Multnomah County, Oregon",499,363,136,499,119,380,499,28,26,18,73,38,44,8,30,31,16,28,53,76,15,6,9,41,051,008002,2,410510080022
"Block Group 1, Census Tract 89.01, Multnomah County, Oregon",1543,1218,325,1543,251,1292,1543,91,0,15,35,18,86,86,17,59,115,114,145,210,106,203,243,41,051,008901,1,410510089011
"Block Group 2, Census Tract 89.01, Multnomah County, Oregon",1117,960,157,1117,350,767,1117,27,118,37,40,125,51,12,23,88,161,81,130,144,0,31,49,41,051,008901,2,410510089012
"Block Group 3, Census Tract 324.06, Washington County, Oregon",723,507,216,723,79,644,723,0,53,80,35,0,38,18,63,58,35,85,59,64,98,21,16,41,067,032406,3,410670324063
"Block Group 4, Census Tract 324.06, Washington County, Oregon",1167,1080,87,1167,23,1144,1167,0,15,0,0,19,16,0,13,30,89,166,236,170,150,145,118,41,067,032406,4,410670324064
"Block Group 3, Census Tract 326.04, Washington County, Oregon",403,329,74,403,187,216,403,74,30,14,0,0,46,94,20,0,21,21,38,45,0,0,0,41,067,032604,3,410670326043
"Block Group 5, Census Tract 326.04, Washington County, Oregon",719,601,118,719,44,675,719,12,13,10,49,0,13,52,23,0,51,144,58,130,49,79,36,41,067,032604,5,410670326045
"Block Group 4, Census Tract 326.04, Washington County, Oregon",497,452,45,497,57,440,497,0,19,0,8,14,23,76,0,0,94,0,59,120,25,59,0,41,067,032604,4,410670326044
"Block Group 1, Census Tract 326.04, Washington County, Oregon",237,197,40,237,0,237,237,14,0,13,36,0,0,27,0,0,20,40,17,57,13,0,0,41,067,032604,1,410670326041
"Block Group 2, Census Tract 326.04, Washington County, Oregon",452,376,76,452,61,391,452,0,13,0,13,0,0,54,18,0,18,52,163,82,27,0,12,41,067,032604,2,410670326042
"Block Group 2, Census Tract 334, Washington County, Oregon",429,367,62,429,20,409,429,15,4,0,9,15,11,23,12,10,31,49,65,46,25,95,19,41,067,033400,2,410670334002
"Block Group 3, Census Tract 600, Douglas County, Oregon",765,386,379,765,55,710,765,21,40,55,64,0,57,18,0,44,66,58,91,75,44,69,63,41,019,060000,3,410190600003
"Block Group 2, Census Tract 600, Douglas County, Oregon",395,267,128,395,68,327,395,0,13,42,27,24,10,26,18,0,49,26,48,29,13,50,20,41,019,060000,2,410190600002
"Block Group 2, Census Tract 700, Douglas County, Oregon",907,596,311,907,81,826,907,33,0,37,150,31,60,55,32,42,47,34,149,74,51,64,48,41,019,070000,2,410190700002
"Block Group 3, Census Tract 700, Douglas County, Oregon",612,420,192,612,77,535,612,11,20,0,19,67,63,98,32,20,16,44,44,53,31,61,33,41,019,070000,3,410190700003
"Block Group 1, Census Tract 700, Douglas County, Oregon",537,345,192,537,43,494,537,0,0,0,79,52,0,63,27,0,10,69,113,17,17,26,64,41,019,070000,1,410190700001
"Block Group 2, Census Tract 2000, Douglas County, Oregon",396,279,117,396,154,242,396,57,12,46,37,25,13,20,32,8,50,70,15,0,0,11,0,41,019,200000,2,410192000002
"Block Group 4, Census Tract 2000, Douglas County, Oregon",617,372,245,617,222,395,617,68,29,34,45,61,46,41,36,35,75,60,79,0,2,6,0,41,019,200000,4,410192000004
"Block Group 4, Census Tract 9602, Grant County, Oregon",739,519,220,739,232,507,739,77,51,34,49,53,22,25,47,29,47,36,179,15,27,15,33,41,023,960200,4,410239602004
"Block Group 5, Census Tract 9602, Grant County, Oregon",382,278,104,382,61,321,382,14,100,19,22,50,20,22,29,9,11,21,33,23,0,2,7,41,023,960200,5,410239602005
"Block Group 1, Census Tract 33.02, Lane County, Oregon",451,390,61,451,114,337,451,32,35,16,21,19,6,11,24,43,22,76,110,25,11,0,0,41,039,003302,1,410390033021
"Block Group 3, Census Tract 33.02, Lane County, Oregon",562,330,232,562,223,339,562,101,44,44,30,88,25,10,64,38,33,21,26,18,9,11,0,41,039,003302,3,410390033023
"Block Group 1, Census Tract 29.04, Lane County, Oregon",465,179,286,465,16,449,465,62,14,25,31,64,10,19,42,7,91,24,34,24,10,0,8,41,039,002904,1,410390029041
"Block Group 2, Census Tract 29.04, Lane County, Oregon",893,472,421,893,134,759,893,50,70,78,13,59,84,56,37,13,52,101,70,71,52,39,48,41,039,002904,2,410390029042
"Block Group 3, Census Tract 29.04, Lane County, Oregon",827,683,144,827,88,739,827,40,24,35,41,17,23,8,24,25,92,115,177,37,39,32,98,41,039,002904,3,410390029043
"Block Group 3, Census Tract 45.02, Lane County, Oregon",956,792,164,956,264,692,956,65,91,43,92,29,64,25,72,28,99,100,51,54,109,25,9,41,039,004502,3,410390045023
"Block Group 1, Census Tract 320.05, Washington County, Oregon",286,271,15,286,0,286,286,17,0,3,4,11,3,0,4,0,8,56,66,29,9,47,29,41,067,032005,1,410670320051
"Block Group 2, Census Tract 320.05, Washington County, Oregon",500,445,55,500,37,463,500,37,0,5,15,62,0,26,2,34,24,66,135,78,1,14,1,41,067,032005,2,410670320052
"Block Group 4, Census Tract 320.05, Washington County, Oregon",311,266,45,311,154,157,311,44,12,32,0,25,36,42,30,0,17,30,17,9,3,14,0,41,067,032005,4,410670320054
"Block Group 1, Census Tract 308.06, Washington County, Oregon",1051,890,161,1051,108,943,1051,21,12,29,52,18,42,57,17,30,52,74,190,73,152,114,118,41,067,030806,1,410670308061
"Block Group 1, Census Tract 326.07, Washington County, Oregon",2909,2521,388,2909,68,2841,2909,87,43,54,51,5,76,48,53,38,143,360,530,438,446,215,322,41,067,032607,1,410670326071
"Block Group 1, Census Tract 326.09, Washington County, Oregon",952,898,54,952,48,904,952,17,5,6,22,7,36,39,32,13,34,133,132,114,73,131,158,41,067,032609,1,410670326091
"Block Group 1, Census Tract 331.01, Washington County, Oregon",1110,967,143,1110,145,965,1110,57,53,8,124,33,49,36,94,35,49,185,112,85,68,61,61,41,067,033101,1,410670331011
"Block Group 1, Census Tract 331.02, Washington County, Oregon",756,570,186,756,170,586,756,9,17,8,29,61,61,66,40,62,96,103,62,85,17,40,0,41,067,033102,1,410670331021
"Block Group 3, Census Tract 332, Washington County, Oregon",1107,543,564,1107,239,868,1107,109,165,17,234,87,30,91,48,25,85,6,105,70,0,35,0,41,067,033200,3,410670332003
"Block Group 2, Census Tract 332, Washington County, Oregon",996,900,96,996,263,733,996,45,63,0,63,23,0,38,103,48,86,214,110,92,0,111,0,41,067,033200,2,410670332002
"Block Group 2, Census Tract 319.11, Washington County, Oregon",996,806,190,996,49,947,996,74,0,13,6,41,29,9,16,47,82,117,182,122,23,134,101,41,067,031911,2,410670319112
"Block Group 3, Census Tract 319.10, Washington County, Oregon",1113,981,132,1113,127,986,1113,35,18,40,32,83,17,32,21,46,29,108,263,56,54,144,135,41,067,031910,3,410670319103
"Block Group 1, Census Tract 45.02, Lane County, Oregon",349,266,83,349,71,278,349,19,54,22,34,34,21,17,17,11,0,20,34,10,29,7,20,41,039,004502,1,410390045021
"Block Group 3, Census Tract 49, Multnomah County, Oregon",940,824,116,940,191,749,940,46,86,0,31,126,18,0,21,22,136,146,109,83,23,59,34,41,051,004900,3,410510049003
"Block Group 3, Census Tract 51, Multnomah County, Oregon",890,609,281,890,127,763,890,38,120,123,91,141,24,28,23,11,0,43,22,71,46,109,0,41,051,005100,3,410510051003
"Block Group 3, Census Tract 52, Multnomah County, Oregon",794,644,150,794,100,694,794,83,53,0,0,51,16,13,33,12,106,100,98,34,104,25,66,41,051,005200,3,410510052003
"Block Group 2, Census Tract 55, Multnomah County, Oregon",758,480,278,758,161,597,758,336,82,26,6,34,8,35,47,0,20,46,19,57,0,0,42,41,051,005500,2,410510055002
"Block Group 2, Census Tract 57, Multnomah County, Oregon",1240,966,274,1240,82,1158,1240,161,12,30,18,36,33,15,64,57,132,110,221,126,52,39,134,41,051,005700,2,410510057002
"Block Group 3, Census Tract 57, Multnomah County, Oregon",607,487,120,607,0,607,607,0,0,15,0,30,0,0,40,18,53,26,123,91,61,55,95,41,051,005700,3,410510057003
"Block Group 4, Census Tract 91.02, Multnomah County, Oregon",772,669,103,772,120,652,772,36,29,0,17,50,39,37,20,95,62,27,63,236,30,31,0,41,051,009102,4,410510091024
"Block Group 4, Census Tract 303.01, Yamhill County, Oregon",1112,897,215,1112,130,982,1112,37,23,85,16,34,58,11,25,32,122,51,228,95,103,135,57,41,071,030301,4,410710303014
"Block Group 5, Census Tract 303.01, Yamhill County, Oregon",349,294,55,349,20,329,349,6,0,0,0,0,0,19,52,0,35,57,16,60,79,7,18,41,071,030301,5,410710303015
"Block Group 3, Census Tract 221.01, Clackamas County, Oregon",779,577,202,779,120,659,779,46,14,32,22,56,54,38,26,27,107,70,116,37,26,69,39,41,005,022101,3,410050221013
"Block Group 3, Census Tract 222.01, Clackamas County, Oregon",1030,818,212,1030,379,651,1030,178,61,35,15,56,30,0,98,35,184,127,195,0,0,0,16,41,005,022201,3,410050222013
"Block Group 5, Census Tract 316.10, Washington County, Oregon",834,738,96,834,115,719,834,0,14,0,42,11,136,68,28,40,99,128,188,34,30,16,0,41,067,031610,5,410670316105
"Block Group 4, Census Tract 98.03, Multnomah County, Oregon",699,340,359,699,252,447,699,48,60,55,190,31,157,20,17,14,17,72,18,0,0,0,0,41,051,009803,4,410510098034
"Block Group 2, Census Tract 20, Deschutes County, Oregon",836,755,81,836,78,758,836,0,13,111,13,15,14,15,22,54,115,144,87,81,32,64,56,41,017,002000,2,410170020002
"Block Group 3, Census Tract 21, Deschutes County, Oregon",2140,1778,362,2140,126,2014,2140,122,0,48,26,36,27,25,86,22,65,318,297,382,132,384,170,41,017,002100,3,410170021003
"Block Group 2, Census Tract 21, Deschutes County, Oregon",1168,1036,132,1168,249,919,1168,19,95,56,54,101,58,57,148,64,121,99,49,92,128,27,0,41,017,002100,2,410170021002
"Block Group 4, Census Tract 21, Deschutes County, Oregon",561,505,56,561,262,299,561,18,132,25,29,0,0,20,0,0,168,49,39,43,0,38,0,41,017,002100,4,410170021004
"Block Group 2, Census Tract 16, Deschutes County, Oregon",1026,653,373,1026,305,721,1026,151,128,47,102,13,40,18,34,50,22,129,98,66,54,17,57,41,017,001600,2,410170016002
"Block Group 1, Census Tract 16, Deschutes County, Oregon",359,256,103,359,127,232,359,34,14,34,44,0,15,46,11,14,59,69,5,0,0,0,14,41,017,001600,1,410170016001
"Block Group 3, Census Tract 201, Linn County, Oregon",363,281,82,363,37,326,363,0,18,13,0,0,0,65,0,18,0,110,35,0,27,40,37,41,043,020100,3,410430201003
"Block Group 4, Census Tract 201, Linn County, Oregon",973,754,219,973,114,859,973,20,29,10,15,67,18,18,8,14,63,83,182,157,161,105,23,41,043,020100,4,410430201004
"Block Group 1, Census Tract 201, Linn County, Oregon",1914,1618,296,1914,241,1673,1914,30,14,29,83,66,57,143,57,92,252,306,306,353,69,44,13,41,043,020100,1,410430201001
"Block Group 2, Census Tract 206, Linn County, Oregon",654,299,355,654,29,625,654,46,0,34,38,12,20,94,32,21,101,0,194,17,45,0,0,41,043,020600,2,410430206002
"Block Group 3, Census Tract 206, Linn County, Oregon",808,758,50,808,47,761,808,0,0,20,23,64,0,28,0,33,110,76,202,83,67,17,85,41,043,020600,3,410430206003
"Block Group 4, Census Tract 206, Linn County, Oregon",259,193,66,259,18,241,259,8,0,0,18,0,21,0,0,24,12,61,65,21,29,0,0,41,043,020600,4,410430206004
"Block Group 1, Census Tract 304.02, Linn County, Oregon",267,155,112,267,117,150,267,35,15,20,18,17,28,47,47,13,14,0,0,13,0,0,0,41,043,030402,1,410430304021
"Block Group 5, Census Tract 304.02, Linn County, Oregon",603,441,162,603,82,521,603,66,51,32,29,17,0,30,0,15,0,290,42,17,14,0,0,41,043,030402,5,410430304025
"Block Group 2, Census Tract 308, Linn County, Oregon",534,434,100,534,81,453,534,39,23,11,14,32,43,11,20,11,103,39,106,82,0,0,0,41,043,030800,2,410430308002
"Block Group 1, Census Tract 1300, Douglas County, Oregon",568,453,115,568,133,435,568,0,23,85,16,14,41,15,31,45,0,55,116,0,70,57,0,41,019,130000,1,410191300001
"Block Group 5, Census Tract 1300, Douglas County, Oregon",301,171,130,301,133,168,301,32,53,30,15,0,54,0,13,15,0,47,7,19,16,0,0,41,019,130000,5,410191300005
"Block Group 2, Census Tract 1300, Douglas County, Oregon",292,261,31,292,76,216,292,82,28,0,28,7,11,0,37,0,29,57,0,13,0,0,0,41,019,130000,2,410191300002
"Block Group 1, Census Tract 3, Coos County, Oregon",423,249,174,423,120,303,423,37,14,16,10,50,43,0,77,30,36,31,44,0,24,11,0,41,011,000300,1,410110003001
"Block Group 4, Census Tract 3, Coos County, Oregon",443,365,78,443,80,363,443,15,26,25,31,40,0,28,9,0,65,18,92,47,47,0,0,41,011,000300,4,410110003004
"Block Group 3, Census Tract 3, Coos County, Oregon",209,148,61,209,27,182,209,0,27,0,0,29,20,5,22,21,10,35,14,11,0,15,0,41,011,000300,3,410110003003
"Block Group 1, Census Tract 4, Coos County, Oregon",418,286,132,418,162,256,418,21,63,28,21,11,0,12,43,0,13,15,43,53,35,37,23,41,011,000400,1,410110004001
"Block Group 4, Census Tract 4, Coos County, Oregon",361,264,97,361,16,345,361,0,0,0,36,16,15,14,11,0,90,72,25,55,0,27,0,41,011,000400,4,410110004004
"Block Group 6, Census Tract 4, Coos County, Oregon",566,440,126,566,137,429,566,61,54,15,23,0,12,66,40,27,13,57,81,0,107,10,0,41,011,000400,6,410110004006
"Block Group 5, Census Tract 4, Coos County, Oregon",503,358,145,503,75,428,503,24,45,16,20,18,0,10,0,24,24,130,8,96,73,0,15,41,011,000400,5,410110004005
"Block Group 2, Census Tract 4, Coos County, Oregon",236,133,103,236,66,170,236,29,0,0,0,14,26,0,15,19,72,14,8,39,0,0,0,41,011,000400,2,410110004002
"Block Group 3, Census Tract 4, Coos County, Oregon",451,362,89,451,109,342,451,18,28,43,8,21,23,36,31,0,18,86,67,0,17,0,55,41,011,000400,3,410110004003
"Block Group 2, Census Tract 5.02, Coos County, Oregon",349,117,232,349,56,293,349,21,81,9,29,9,68,0,0,30,26,0,50,9,0,8,9,41,011,000502,2,410110005022
"Block Group 1, Census Tract 5.02, Coos County, Oregon",899,552,347,899,138,761,899,0,27,102,55,91,26,25,95,70,41,178,101,15,33,29,11,41,011,000502,1,410110005021
"Block Group 2, Census Tract 9, Coos County, Oregon",576,290,286,576,104,472,576,21,0,31,58,32,119,83,16,11,25,81,46,33,0,0,20,41,011,000900,2,410110009002
"Block Group 1, Census Tract 9, Coos County, Oregon",373,161,212,373,10,363,373,18,7,14,14,16,26,0,39,0,19,26,62,106,0,0,26,41,011,000900,1,410110009001
"Block Group 6, Census Tract 9, Coos County, Oregon",381,280,101,381,101,280,381,0,0,57,58,14,18,1,0,40,29,0,56,72,0,36,0,41,011,000900,6,410110009006
"Block Group 8, Census Tract 9, Coos County, Oregon",199,115,84,199,19,180,199,32,0,21,8,0,0,0,0,0,5,50,41,0,0,18,24,41,011,000900,8,410110009008
"Block Group 4, Census Tract 9, Coos County, Oregon",526,312,214,526,157,369,526,24,43,15,61,42,44,68,32,21,25,96,41,0,0,14,0,41,011,000900,4,410110009004
"Block Group 7, Census Tract 9, Coos County, Oregon",389,269,120,389,125,264,389,0,57,13,18,72,20,0,25,0,56,20,14,29,0,56,9,41,011,000900,7,410110009007
"Block Group 2, Census Tract 9501, Curry County, Oregon",518,325,193,518,207,311,518,77,44,19,17,57,16,30,19,41,9,83,50,11,6,39,0,41,015,950100,2,410159501002
"Block Group 3, Census Tract 9502, Curry County, Oregon",926,510,416,926,138,788,926,22,29,29,88,102,41,43,15,18,74,16,126,16,70,111,126,41,015,950200,3,410159502003
"Block Group 1, Census Tract 9502, Curry County, Oregon",848,439,409,848,172,676,848,53,122,15,65,54,52,39,21,48,100,104,78,52,9,11,25,41,015,950200,1,410159502001
"Block Group 2, Census Tract 9503.01, Curry County, Oregon",378,222,156,378,54,324,378,0,71,0,28,23,0,0,20,0,39,44,36,84,0,33,0,41,015,950301,2,410159503012
"Block Group 1, Census Tract 9503.01, Curry County, Oregon",1031,578,453,1031,78,953,1031,36,68,52,48,39,38,80,35,18,63,15,155,261,49,74,0,41,015,950301,1,410159503011
"Block Group 1, Census Tract 12.01, Lane County, Oregon",629,478,151,629,152,477,629,15,60,7,74,43,11,20,38,0,50,84,112,20,53,14,28,41,039,001201,1,410390012011
"Block Group 3, Census Tract 12.01, Lane County, Oregon",415,294,121,415,143,272,415,34,39,12,16,0,65,0,49,20,26,77,68,0,9,0,0,41,039,001201,3,410390012013
"Block Group 1, Census Tract 31.02, Lane County, Oregon",504,370,134,504,61,443,504,0,42,0,0,41,50,43,92,0,19,44,27,10,30,66,40,41,039,003102,1,410390031021
"Block Group 2, Census Tract 31.02, Lane County, Oregon",628,546,82,628,16,612,628,12,18,11,0,0,0,0,40,0,12,128,107,89,71,63,77,41,039,003102,2,410390031022
"Block Group 2, Census Tract 37, Lane County, Oregon",0,0,0,0,0,0,0,0,0,0,0,0,0,0,0,0,0,0,0,0,0,0,0,41,039,003700,2,410390037002
"Block Group 2, Census Tract 90, Multnomah County, Oregon",1020,850,170,1020,343,677,1020,47,0,151,14,18,101,40,48,42,88,136,155,48,30,89,13,41,051,009000,2,410510090002
"Block Group 1, Census Tract 90, Multnomah County, Oregon",1151,784,367,1151,407,744,1151,173,128,40,116,0,34,85,0,66,80,142,67,117,24,20,59,41,051,009000,1,410510090001
"Block Group 2, Census Tract 92.02, Multnomah County, Oregon",465,388,77,465,148,317,465,26,26,29,10,12,58,27,62,26,25,47,84,7,0,13,13,41,051,009202,2,410510092022
"Block Group 2, Census Tract 93.01, Multnomah County, Oregon",719,546,173,719,281,438,719,104,166,10,25,0,0,0,27,53,73,63,99,53,27,0,19,41,051,009301,2,410510093012
"Block Group 3, Census Tract 93.01, Multnomah County, Oregon",829,543,286,829,506,323,829,125,98,78,107,12,64,14,0,72,44,134,58,10,0,13,0,41,051,009301,3,410510093013
"Block Group 1, Census Tract 98.01, Multnomah County, Oregon",779,642,137,779,334,445,779,117,97,95,61,52,36,59,11,57,63,26,48,57,0,0,0,41,051,009801,1,410510098011
"Block Group 2, Census Tract 84, Multnomah County, Oregon",1044,825,219,1044,343,701,1044,48,117,26,88,59,137,43,93,51,112,91,48,77,17,37,0,41,051,008400,2,410510084002
"Block Group 1, Census Tract 89.02, Multnomah County, Oregon",981,794,187,981,53,928,981,35,9,0,10,53,49,24,0,75,75,93,268,107,72,89,22,41,051,008902,1,410510089021
"Block Group 2, Census Tract 91.01, Multnomah County, Oregon",867,663,204,867,380,487,867,109,39,44,25,114,27,25,32,32,122,107,73,45,25,34,14,41,051,009101,2,410510091012
"Block Group 1, Census Tract 91.01, Multnomah County, Oregon",1190,798,392,1190,453,737,1190,173,88,64,101,47,67,10,71,98,127,132,104,56,52,0,0,41,051,009101,1,410510091011
"Block Group 1, Census Tract 104.02, Multnomah County, Oregon",651,571,80,651,68,583,651,33,16,0,0,0,34,16,0,23,56,47,60,102,44,163,57,41,051,010402,1,410510104021
"Block Group 2, Census Tract 104.02, Multnomah County, Oregon",773,696,77,773,26,747,773,0,0,0,14,0,17,0,64,27,45,95,133,152,112,41,73,41,051,010402,2,410510104022
"Block Group 3, Census Tract 104.08, Multnomah County, Oregon",433,356,77,433,185,248,433,0,20,0,57,0,70,18,0,58,115,23,39,33,0,0,0,41,051,010408,3,410510104083
"Block Group 2, Census Tract 104.08, Multnomah County, Oregon",606,478,128,606,121,485,606,40,0,95,53,35,52,0,19,12,47,75,67,73,12,12,14,41,051,010408,2,410510104082
"Block Group 2, Census Tract 9602, Grant County, Oregon",300,201,99,300,88,212,300,28,23,36,16,15,0,43,7,0,8,16,30,42,8,25,3,41,023,960200,2,410239602002
"Block Group 6, Census Tract 308, Linn County, Oregon",676,552,124,676,143,533,676,106,0,77,27,0,35,0,72,76,89,11,115,27,0,41,0,41,043,030800,6,410430308006
"Block Group 4, Census Tract 308, Linn County, Oregon",369,115,254,369,93,276,369,74,57,27,63,24,11,11,20,15,29,12,0,26,0,0,0,41,043,030800,4,410430308004
"Block Group 5, Census Tract 301, Linn County, Oregon",419,317,102,419,56,363,419,0,0,15,75,37,0,0,0,64,37,47,24,54,33,33,0,41,043,030100,5,410430301005
"Block Group 4, Census Tract 301, Linn County, Oregon",471,323,148,471,55,416,471,0,21,0,36,33,18,17,37,0,38,99,66,55,18,0,33,41,043,030100,4,410430301004
"Block Group 2, Census Tract 9602, Tillamook County, Oregon",335,198,137,335,75,260,335,15,30,11,14,23,34,14,17,26,26,32,32,33,6,10,12,41,057,960200,2,410579602002
"Block Group 3, Census Tract 9608, Tillamook County, Oregon",384,207,177,384,6,378,384,17,9,12,10,22,30,18,0,17,80,60,38,15,11,15,30,41,057,960800,3,410579608003
"Block Group 2, Census Tract 9608, Tillamook County, Oregon",261,158,103,261,11,250,261,21,11,12,10,18,0,60,0,22,0,6,68,13,9,0,11,41,057,960800,2,410579608002
"Block Group 3, Census Tract 9606, Tillamook County, Oregon",477,240,237,477,8,469,477,0,29,0,14,22,39,7,28,11,27,67,65,32,28,50,58,41,057,960600,3,410579606003
"Block Group 2, Census Tract 9601, Tillamook County, Oregon",462,283,179,462,50,412,462,0,46,18,32,19,42,21,32,4,62,64,12,59,18,18,15,41,057,960100,2,410579601002
"Block Group 4, Census Tract 9601, Tillamook County, Oregon",334,216,118,334,70,264,334,23,16,5,31,12,32,5,21,26,25,35,68,24,5,0,6,41,057,960100,4,410579601004
"Block Group 3, Census Tract 9601, Tillamook County, Oregon",255,91,164,255,16,239,255,16,0,5,17,7,8,16,2,5,16,69,37,19,5,17,16,41,057,960100,3,410579601003
"Block Group 5, Census Tract 9604, Tillamook County, Oregon",444,355,89,444,133,311,444,0,15,65,14,15,43,44,0,42,0,45,69,79,13,0,0,41,057,960400,5,410579604005
"Block Group 7, Census Tract 9604, Tillamook County, Oregon",483,368,115,483,38,445,483,0,0,0,43,15,0,11,63,15,38,165,33,28,31,41,0,41,057,960400,7,410579604007
"Block Group 4, Census Tract 9604, Tillamook County, Oregon",197,120,77,197,42,155,197,0,22,18,0,26,8,0,0,23,33,0,40,14,13,0,0,41,057,960400,4,410579604004
"Block Group 1, Census Tract 13.01, Lane County, Oregon",473,248,225,473,154,319,473,139,0,44,16,22,24,22,28,9,49,21,36,37,0,0,26,41,039,001301,1,410390013011
"Block Group 3, Census Tract 18.03, Lane County, Oregon",477,292,185,477,161,316,477,62,15,33,70,20,32,10,0,24,59,30,32,47,35,8,0,41,039,001803,3,410390018033
"Block Group 2, Census Tract 18.03, Lane County, Oregon",618,550,68,618,137,481,618,19,51,14,27,44,47,16,26,18,51,107,41,48,60,41,8,41,039,001803,2,410390018032
"Block Group 1, Census Tract 19.04, Lane County, Oregon",954,840,114,954,100,854,954,66,16,55,78,66,71,0,73,0,58,191,123,122,35,0,0,41,039,001904,1,410390019041
"Block Group 2, Census Tract 20.01, Lane County, Oregon",623,404,219,623,126,497,623,0,13,64,0,19,11,0,66,50,101,52,84,110,27,17,9,41,039,002001,2,410390020012
"Block Group 2, Census Tract 22.02, Lane County, Oregon",439,328,111,439,0,439,439,18,0,0,16,17,68,17,16,87,33,31,31,44,47,0,14,41,039,002202,2,410390022022
"Block Group 3, Census Tract 22.02, Lane County, Oregon",1549,1113,436,1549,160,1389,1549,125,0,89,121,89,47,62,18,38,181,118,125,97,131,123,185,41,039,002202,3,410390022023
"Block Group 1, Census Tract 38, Lane County, Oregon",403,341,62,403,18,385,403,151,20,99,24,0,0,0,20,72,0,0,0,0,17,0,0,41,039,003800,1,410390038001
"Block Group 4, Census Tract 38, Lane County, Oregon",880,816,64,880,71,809,880,264,201,88,0,80,41,49,24,0,86,0,47,0,0,0,0,41,039,003800,4,410390038004
"Block Group 5, Census Tract 38, Lane County, Oregon",1128,977,151,1128,262,866,1128,561,137,53,165,60,42,0,0,20,23,0,18,0,0,49,0,41,039,003800,5,410390038005
"Block Group 1, Census Tract 208.01, Linn County, Oregon",337,286,51,337,108,229,337,5,6,14,45,14,41,56,7,30,8,33,53,6,8,6,5,41,043,020801,1,410430208011
"Block Group 2, Census Tract 9400, Jefferson County, Oregon",476,393,83,476,298,178,476,50,17,48,60,0,16,30,7,30,69,42,33,25,33,5,11,41,031,940000,2,410319400002
"Block Group 1, Census Tract 9400, Jefferson County, Oregon",360,262,98,360,156,204,360,60,8,51,23,24,2,15,7,6,13,30,75,30,5,11,0,41,031,940000,1,410319400001
"Block Group 2, Census Tract 9603.02, Jefferson County, Oregon",330,271,59,330,77,253,330,12,6,7,35,9,25,18,11,28,33,45,33,42,2,19,5,41,031,960302,2,410319603022
"Block Group 3, Census Tract 319.12, Washington County, Oregon",261,172,89,261,40,221,261,0,0,20,10,13,0,21,10,0,43,50,33,20,10,12,19,41,067,031912,3,410670319123
"Block Group 2, Census Tract 319.12, Washington County, Oregon",596,525,71,596,72,524,596,10,0,0,13,0,21,0,10,31,85,39,126,69,17,100,75,41,067,031912,2,410670319122
"Block Group 1, Census Tract 316.16, Washington County, Oregon",663,355,308,663,20,643,663,33,0,19,20,20,55,49,28,45,56,56,71,52,21,60,78,41,067,031616,1,410670316161
"Block Group 2, Census Tract 316.16, Washington County, Oregon",1110,940,170,1110,90,1020,1110,38,9,58,43,0,78,127,60,38,76,172,207,98,27,45,34,41,067,031616,2,410670316162
"Block Group 3, Census Tract 316.09, Washington County, Oregon",842,679,163,842,76,766,842,11,56,0,44,0,0,0,0,0,80,48,211,52,116,181,43,41,067,031609,3,410670316093
"Block Group 2, Census Tract 316.09, Washington County, Oregon",2638,2311,327,2638,464,2174,2638,159,79,90,120,130,28,137,132,91,469,385,447,125,146,43,57,41,067,031609,2,410670316092
"Block Group 4, Census Tract 316.09, Washington County, Oregon",1017,919,98,1017,210,807,1017,0,43,15,75,42,77,13,0,41,66,164,82,151,35,51,162,41,067,031609,4,410670316094
"Block Group 2, Census Tract 315.14, Washington County, Oregon",965,864,101,965,42,923,965,19,0,0,0,27,32,49,12,24,8,47,97,170,65,220,195,41,067,031514,2,410670315142
"Block Group 1, Census Tract 315.14, Washington County, Oregon",468,441,27,468,0,468,468,0,0,0,0,54,0,20,0,21,0,29,59,23,0,45,217,41,067,031514,1,410670315141
"Block Group 2, Census Tract 9.02, Multnomah County, Oregon",615,553,62,615,133,482,615,18,14,35,20,12,83,0,0,60,24,39,93,115,53,28,21,41,051,000902,2,410510009022
"Block Group 3, Census Tract 9.02, Multnomah County, Oregon",461,450,11,461,107,354,461,14,24,25,16,0,33,9,25,42,32,31,92,39,37,23,19,41,051,000902,3,410510009023
"Block Group 1, Census Tract 9.02, Multnomah County, Oregon",927,828,99,927,117,810,927,14,11,63,27,70,42,24,42,36,190,70,93,32,36,135,42,41,051,000902,1,410510009021
"Block Group 2, Census Tract 100.01, Multnomah County, Oregon",476,415,61,476,168,308,476,15,11,13,29,94,0,17,15,59,17,73,107,26,0,0,0,41,051,010001,2,410510100012
"Block Group 2, Census Tract 11, Deschutes County, Oregon",724,624,100,724,18,706,724,18,0,0,10,0,0,0,0,36,130,46,57,94,193,29,111,41,017,001100,2,410170011002
"Block Group 1, Census Tract 11, Deschutes County, Oregon",1320,956,364,1320,49,1271,1320,0,29,21,18,23,76,68,42,19,111,121,112,79,121,192,288,41,017,001100,1,410170011001
"Block Group 2, Census Tract 7, Deschutes County, Oregon",1390,1092,298,1390,268,1122,1390,49,11,32,24,144,42,54,44,112,176,137,265,164,48,68,20,41,017,000700,2,410170007002
"Block Group 2, Census Tract 52, Lane County, Oregon",587,459,128,587,30,557,587,9,0,11,7,0,44,33,30,39,45,54,101,98,31,57,28,41,039,005200,2,410390052002
"Block Group 1, Census Tract 35, Lane County, Oregon",337,260,77,337,119,218,337,12,13,21,8,50,30,0,29,16,60,4,33,9,22,21,9,41,039,003500,1,410390035001
"Block Group 1, Census Tract 36, Lane County, Oregon",619,379,240,619,329,290,619,68,100,87,69,38,11,75,27,14,39,53,38,0,0,0,0,41,039,003600,1,410390036001
"Block Group 2, Census Tract 36, Lane County, Oregon",376,294,82,376,24,352,376,7,13,0,0,0,0,6,8,10,28,53,54,12,19,57,109,41,039,003600,2,410390036002
"Block Group 4, Census Tract 36.01, Multnomah County, Oregon",511,466,45,511,87,424,511,12,10,11,0,0,7,9,8,10,25,114,128,32,44,39,62,41,051,003601,4,410510036014
"Block Group 3, Census Tract 36.01, Multnomah County, Oregon",558,496,62,558,115,443,558,122,12,0,0,8,6,10,11,9,44,101,90,43,43,23,36,41,051,003601,3,410510036013
"Block Group 1, Census Tract 36.01, Multnomah County, Oregon",289,259,30,289,16,273,289,10,0,0,0,8,8,0,0,27,15,24,58,28,38,26,47,41,051,003601,1,410510036011
"Block Group 3, Census Tract 40.01, Multnomah County, Oregon",535,452,83,535,54,481,535,0,0,50,34,0,92,19,79,42,0,17,97,44,32,17,12,41,051,004001,3,410510040013
"Block Group 4, Census Tract 40.01, Multnomah County, Oregon",893,795,98,893,77,816,893,19,0,0,43,34,77,60,0,42,86,143,163,102,66,31,27,41,051,004001,4,410510040014
"Block Group 1, Census Tract 52, Multnomah County, Oregon",589,371,218,589,226,363,589,178,82,28,12,57,14,64,19,0,0,36,18,15,0,47,19,41,051,005200,1,410510052001
"Block Group 1, Census Tract 57, Multnomah County, Oregon",605,418,187,605,39,566,605,67,0,0,21,17,36,28,43,56,11,38,103,26,18,36,105,41,051,005700,1,410510057001
"Block Group 1, Census Tract 60.01, Multnomah County, Oregon",446,358,88,446,51,395,446,10,26,0,7,24,32,0,23,0,19,59,72,40,35,41,58,41,051,006001,1,410510060011
"Block Group 2, Census Tract 65.01, Multnomah County, Oregon",855,697,158,855,13,842,855,0,32,46,16,27,73,0,30,0,53,80,106,127,61,15,189,41,051,006501,2,410510065012
"Block Group 2, Census Tract 9706, Wasco County, Oregon",625,457,168,625,177,448,625,0,44,28,59,47,13,36,16,53,69,83,97,50,6,8,16,41,065,970600,2,410659706002
"Block Group 2, Census Tract 9703, Wasco County, Oregon",356,303,53,356,39,317,356,28,13,0,0,7,0,9,11,38,12,84,62,43,10,39,0,41,065,970300,2,410659703002
"Block Group 4, Census Tract 103.06, Marion County, Oregon",384,227,157,384,84,300,384,0,18,9,42,29,12,50,0,16,22,71,67,35,13,0,0,41,047,010306,4,410470103064
"Block Group 5, Census Tract 103.06, Marion County, Oregon",268,166,102,268,57,211,268,50,0,37,0,26,0,0,0,0,13,23,61,44,14,0,0,41,047,010306,5,410470103065
"Block Group 1, Census Tract 103.06, Marion County, Oregon",1439,1038,401,1439,248,1191,1439,32,37,49,117,61,35,89,164,111,138,152,202,143,0,109,0,41,047,010306,1,410470103061
"Block Group 3, Census Tract 103.06, Marion County, Oregon",169,124,45,169,78,91,169,0,0,77,0,0,18,28,0,15,0,16,0,0,0,0,15,41,047,010306,3,410470103063
"Block Group 2, Census Tract 103.06, Marion County, Oregon",670,655,15,670,334,336,670,56,79,55,0,0,134,0,0,113,0,153,27,43,10,0,0,41,047,010306,2,410470103062
"Block Group 1, Census Tract 14.02, Marion County, Oregon",563,486,77,563,101,462,563,0,0,0,0,20,46,15,25,0,26,46,83,76,126,38,62,41,047,001402,1,410470014021
"Block Group 2, Census Tract 14.02, Marion County, Oregon",635,397,238,635,187,448,635,87,14,79,20,0,15,12,0,35,123,49,79,41,40,41,0,41,047,001402,2,410470014022
"Block Group 3, Census Tract 14.02, Marion County, Oregon",1110,871,239,1110,119,991,1110,48,53,142,8,13,0,86,19,81,108,159,258,72,45,18,0,41,047,001402,3,410470014023
"Block Group 4, Census Tract 10.01, Deschutes County, Oregon",1191,1140,51,1191,165,1026,1191,26,0,37,26,0,0,67,109,136,70,274,125,264,31,0,26,41,017,001001,4,410170010014
"Block Group 2, Census Tract 10.01, Deschutes County, Oregon",1640,1443,197,1640,264,1376,1640,0,54,0,78,117,52,95,81,28,89,339,288,258,83,64,14,41,017,001001,2,410170010012
"Block Group 3, Census Tract 10.01, Deschutes County, Oregon",487,415,72,487,116,371,487,0,0,116,0,0,0,0,57,0,56,0,75,83,100,0,0,41,017,001001,3,410170010013
"Block Group 1, Census Tract 4.01, Deschutes County, Oregon",1204,1045,159,1204,183,1021,1204,19,106,8,43,84,31,31,57,65,86,210,198,105,85,60,16,41,017,000401,1,410170004011
"Block Group 2, Census Tract 4.01, Deschutes County, Oregon",928,702,226,928,98,830,928,63,49,18,20,74,6,21,12,67,30,82,217,156,21,39,53,41,017,000401,2,410170004012
"Block Group 3, Census Tract 7.01, Marion County, Oregon",276,220,56,276,63,213,276,8,0,17,35,8,5,85,26,0,10,82,0,0,0,0,0,41,047,000701,3,410470007013
"Block Group 2, Census Tract 7.01, Marion County, Oregon",682,464,218,682,246,436,682,16,67,47,8,40,79,49,18,0,29,94,129,50,56,0,0,41,047,000701,2,410470007012
"Block Group 1, Census Tract 5.02, Marion County, Oregon",340,289,51,340,57,283,340,14,44,0,15,38,86,43,0,0,11,6,38,0,45,0,0,41,047,000502,1,410470005021
"Block Group 2, Census Tract 5.02, Marion County, Oregon",488,403,85,488,243,245,488,14,84,15,18,23,33,14,23,34,31,115,34,50,0,0,0,41,047,000502,2,410470005022
"Block Group 2, Census Tract 14.01, Marion County, Oregon",562,466,96,562,72,490,562,0,18,0,25,16,12,12,6,56,52,76,61,43,100,61,24,41,047,001401,2,410470014012
"Block Group 2, Census Tract 25.02, Marion County, Oregon",933,666,267,933,126,807,933,95,9,8,32,20,82,21,25,70,115,80,153,39,79,92,13,41,047,002502,2,410470025022
"Block Group 1, Census Tract 25.02, Marion County, Oregon",638,538,100,638,42,596,638,20,15,21,6,0,25,34,19,23,44,129,91,46,41,70,54,41,047,002502,1,410470025021
"Block Group 4, Census Tract 17, Jackson County, Oregon",1423,875,548,1423,366,1057,1423,170,130,103,68,57,74,32,57,22,122,210,198,81,48,38,13,41,029,001700,4,410290017004
"Block Group 3, Census Tract 29.01, Multnomah County, Oregon",481,365,116,481,9,472,481,12,8,0,53,34,36,14,6,11,24,110,44,34,55,27,13,41,051,002901,3,410510029013
"Block Group 1, Census Tract 29.01, Multnomah County, Oregon",356,322,34,356,6,350,356,0,0,0,0,6,14,12,21,31,0,56,78,45,22,37,34,41,051,002901,1,410510029011
"Block Group 2, Census Tract 29.01, Multnomah County, Oregon",389,346,43,389,25,364,389,0,15,0,0,0,0,2,24,0,7,23,91,48,34,37,108,41,051,002901,2,410510029012
"Block Group 2, Census Tract 36.03, Multnomah County, Oregon",370,343,27,370,41,329,370,10,0,4,33,19,24,12,5,5,0,17,66,40,37,56,42,41,051,003603,2,410510036032
"Block Group 2, Census Tract 40.02, Multnomah County, Oregon",361,309,52,361,73,288,361,6,0,0,15,15,17,0,15,0,43,64,52,18,49,43,24,41,051,004002,2,410510040022
"Block Group 3, Census Tract 40.02, Multnomah County, Oregon",572,498,74,572,119,453,572,15,15,16,15,15,18,7,8,19,28,97,71,51,106,50,41,41,051,004002,3,410510040023
"Block Group 4, Census Tract 40.02, Multnomah County, Oregon",417,346,71,417,51,366,417,40,8,9,0,33,16,0,16,20,39,71,70,18,28,31,18,41,051,004002,4,410510040024
"Block Group 3, Census Tract 41.02, Multnomah County, Oregon",518,390,128,518,28,490,518,0,13,42,20,0,13,0,29,16,10,91,66,32,51,65,70,41,051,004102,3,410510041023
"Block Group 2, Census Tract 41.02, Multnomah County, Oregon",379,300,79,379,63,316,379,13,17,0,0,31,15,0,20,0,18,13,47,42,56,93,14,41,051,004102,2,410510041022
"Block Group 1, Census Tract 45, Multnomah County, Oregon",1429,1247,182,1429,105,1324,1429,34,74,21,32,10,46,55,55,42,114,107,167,324,58,105,185,41,051,004500,1,410510045001
"Block Group 3, Census Tract 28.02, Multnomah County, Oregon",553,476,77,553,99,454,553,16,10,14,0,19,21,6,6,11,71,24,148,99,66,28,14,41,051,002802,3,410510028023
"Block Group 2, Census Tract 28.02, Multnomah County, Oregon",452,405,47,452,19,433,452,18,3,0,0,0,7,10,0,10,23,25,59,113,34,45,105,41,051,002802,2,410510028022
"Block Group 1, Census Tract 36.02, Multnomah County, Oregon",536,484,52,536,19,517,536,3,0,19,18,0,0,0,9,20,42,34,93,52,33,100,113,41,051,003602,1,410510036021
"Block Group 2, Census Tract 36.02, Multnomah County, Oregon",733,643,90,733,29,704,733,0,15,0,21,17,19,0,11,48,38,68,46,30,196,142,82,41,051,003602,2,410510036022
"Block Group 1, Census Tract 51, Multnomah County, Oregon",3410,2281,1129,3410,588,2822,3410,444,91,130,314,72,215,184,0,38,53,107,203,628,254,272,405,41,051,005100,1,410510051001
"Block Group 2, Census Tract 51, Multnomah County, Oregon",1874,1213,661,1874,802,1072,1874,343,265,143,98,179,0,59,26,0,43,130,23,174,77,52,262,41,051,005100,2,410510051002
"Block Group 1, Census Tract 86, Multnomah County, Oregon",783,708,75,783,265,518,783,21,22,8,18,42,30,48,21,31,130,126,80,63,87,41,15,41,051,008600,1,410510086001
"Block Group 2, Census Tract 86, Multnomah County, Oregon",737,606,131,737,218,519,737,25,42,22,96,42,10,76,26,37,59,60,124,73,22,23,0,41,051,008600,2,410510086002
"Block Group 1, Census Tract 71, Multnomah County, Oregon",784,638,146,784,42,742,784,0,24,0,0,34,11,0,18,23,44,103,173,93,101,62,98,41,051,007100,1,410510071001
"Block Group 2, Census Tract 80.01, Multnomah County, Oregon",729,513,216,729,76,653,729,53,7,42,42,38,64,25,75,63,36,135,96,39,9,5,0,41,051,008001,2,410510080012
"Block Group 1, Census Tract 85, Multnomah County, Oregon",1071,868,203,1071,246,825,1071,72,57,0,25,45,30,34,94,21,152,125,232,43,66,0,75,41,051,008500,1,410510085001
"Block Group 2, Census Tract 306, Washington County, Oregon",774,524,250,774,85,689,774,20,69,98,15,54,65,16,29,37,101,16,73,32,18,70,61,41,067,030600,2,410670306002
"Block Group 3, Census Tract 100.01, Multnomah County, Oregon",1451,1021,430,1451,449,1002,1451,117,82,153,171,79,81,116,101,53,61,95,111,114,0,87,30,41,051,010001,3,410510100013
"Block Group 2, Census Tract 4.01, Multnomah County, Oregon",249,241,8,249,14,235,249,21,0,8,8,0,0,0,0,0,24,58,22,45,25,38,0,41,051,000401,2,410510004012
"Block Group 4, Census Tract 4.01, Multnomah County, Oregon",255,204,51,255,7,248,255,0,14,0,0,0,14,0,25,0,11,28,26,42,11,58,26,41,051,000401,4,410510004014
"Block Group 1, Census Tract 4.01, Multnomah County, Oregon",541,466,75,541,53,488,541,28,0,0,20,0,0,9,38,0,95,79,94,87,37,38,16,41,051,000401,1,410510004011
"Block Group 3, Census Tract 4.01, Multnomah County, Oregon",467,397,70,467,43,424,467,17,8,10,0,42,0,9,11,0,31,87,69,97,31,20,35,41,051,000401,3,410510004013
"Block Group 4, Census Tract 41.01, Multnomah County, Oregon",746,633,113,746,135,611,746,18,17,16,0,103,74,0,151,22,28,146,55,81,18,17,0,41,051,004101,4,410510041014
"Block Group 1, Census Tract 41.01, Multnomah County, Oregon",314,289,25,314,72,242,314,0,17,11,0,0,0,28,21,0,47,75,57,1,37,14,6,41,051,004101,1,410510041011
"Block Group 3, Census Tract 41.01, Multnomah County, Oregon",1263,1081,182,1263,172,1091,1263,109,0,119,37,62,15,58,0,22,119,211,279,151,18,43,20,41,051,004101,3,410510041013
"Block Group 2, Census Tract 41.01, Multnomah County, Oregon",576,537,39,576,88,488,576,16,0,14,14,0,0,10,42,12,54,161,89,68,37,59,0,41,051,004101,2,410510041012
"Block Group 1, Census Tract 56, Multnomah County, Oregon",1121,730,391,1121,203,918,1121,213,57,82,97,142,122,13,34,0,87,27,216,16,6,9,0,41,051,005600,1,410510056001
"Block Group 3, Census Tract 56, Multnomah County, Oregon",520,411,109,520,78,442,520,157,27,0,33,40,68,66,18,15,41,55,0,0,0,0,0,41,051,005600,3,410510056003
"Block Group 1, Census Tract 324.04, Washington County, Oregon",285,256,29,285,2,283,285,0,0,0,0,0,22,18,19,19,0,74,44,0,0,48,41,41,067,032404,1,410670324041
"Block Group 1, Census Tract 314.02, Washington County, Oregon",648,562,86,648,124,524,648,78,17,0,58,37,24,62,62,40,67,106,46,28,12,11,0,41,067,031402,1,410670314021
"Block Group 3, Census Tract 314.04, Washington County, Oregon",908,783,125,908,72,836,908,20,0,11,51,61,21,21,11,30,149,73,136,109,70,58,87,41,067,031404,3,410670314043
"Block Group 4, Census Tract 314.04, Washington County, Oregon",451,387,64,451,28,423,451,0,0,10,0,0,0,0,41,8,19,69,58,101,77,68,0,41,067,031404,4,410670314044
"Block Group 1, Census Tract 315.08, Washington County, Oregon",850,820,30,850,9,841,850,0,0,21,24,0,16,0,0,0,40,0,12,92,103,240,302,41,067,031508,1,410670315081
"Block Group 2, Census Tract 315.08, Washington County, Oregon",596,542,54,596,0,596,596,8,0,0,0,0,0,0,0,0,0,17,55,13,39,61,403,41,067,031508,2,410670315082
"Block Group 2, Census Tract 315.11, Washington County, Oregon",215,187,28,215,20,195,215,12,0,10,0,0,10,10,0,15,9,19,66,55,0,0,9,41,067,031511,2,410670315112
"Block Group 1, Census Tract 318.06, Washington County, Oregon",570,509,61,570,21,549,570,0,10,0,26,23,26,0,56,0,71,158,56,60,44,40,0,41,067,031806,1,410670318061
"Block Group 3, Census Tract 318.06, Washington County, Oregon",900,778,122,900,62,838,900,0,12,0,23,10,0,20,0,53,74,69,156,186,49,142,106,41,067,031806,3,410670318063
"Block Group 4, Census Tract 322, Washington County, Oregon",331,271,60,331,0,331,331,50,0,0,0,10,0,13,0,0,14,31,33,18,30,46,86,41,067,032200,4,410670322004
"Block Group 2, Census Tract 322, Washington County, Oregon",438,293,145,438,15,423,438,43,0,12,31,28,0,0,12,12,15,8,173,18,37,6,43,41,067,032200,2,410670322002
"Block Group 3, Census Tract 322, Washington County, Oregon",408,249,159,408,0,408,408,0,0,0,0,14,58,13,0,33,26,26,66,49,35,41,47,41,067,032200,3,410670322003
"Block Group 1, Census Tract 313, Washington County, Oregon",775,660,115,775,119,656,775,42,85,61,32,88,91,80,50,0,29,60,64,44,0,16,33,41,067,031300,1,410670313001
"Block Group 4, Census Tract 9504, Curry County, Oregon",424,107,317,424,44,380,424,42,24,24,18,34,29,0,21,13,83,44,17,17,18,40,0,41,015,950400,4,410159504004
"Block Group 3, Census Tract 9503.02, Curry County, Oregon",628,322,306,628,78,550,628,71,24,70,107,11,13,57,0,12,54,52,77,64,0,0,16,41,015,950302,3,410159503023
"Block Group 2, Census Tract 82.01, Multnomah County, Oregon",469,401,68,469,44,425,469,7,22,18,6,7,10,0,21,37,39,27,114,107,4,39,11,41,051,008201,2,410510082012
"Block Group 1, Census Tract 96.03, Multnomah County, Oregon",675,551,124,675,123,552,675,9,8,9,66,24,20,72,33,47,73,42,109,76,60,19,8,41,051,009603,1,410510096031
"Block Group 1, Census Tract 102, Multnomah County, Oregon",539,410,129,539,44,495,539,25,0,0,0,90,0,71,3,19,26,46,139,120,0,0,0,41,051,010200,1,410510102001
"Block Group 1, Census Tract 9708, Union County, Oregon",324,184,140,324,44,280,324,31,11,51,9,20,29,35,24,13,17,13,37,16,6,10,2,41,061,970800,1,410619708001
"Block Group 4, Census Tract 9708, Union County, Oregon",439,338,101,439,74,365,439,8,4,14,25,11,5,20,28,16,44,67,61,25,50,16,45,41,061,970800,4,410619708004
"Block Group 2, Census Tract 9706, Union County, Oregon",440,385,55,440,0,440,440,0,22,0,8,19,0,38,18,0,0,82,107,56,45,9,36,41,061,970600,2,410619706002
"Block Group 4, Census Tract 203, Linn County, Oregon",424,399,25,424,26,398,424,0,0,0,10,71,12,31,31,12,14,94,91,39,0,0,19,41,043,020300,4,410430203004
"Block Group 1, Census Tract 203, Linn County, Oregon",300,237,63,300,51,249,300,0,0,10,0,0,0,21,18,0,12,47,35,12,117,18,10,41,043,020300,1,410430203001
"Block Group 2, Census Tract 203, Linn County, Oregon",369,254,115,369,134,235,369,101,12,0,17,0,12,61,30,23,0,9,41,12,41,10,0,41,043,020300,2,410430203002
"Block Group 2, Census Tract 204, Linn County, Oregon",399,315,84,399,126,273,399,47,9,7,50,23,46,51,20,19,17,60,27,15,8,0,0,41,043,020400,2,410430204002
"Block Group 4, Census Tract 204, Linn County, Oregon",512,351,161,512,229,283,512,65,19,14,54,51,32,9,90,8,13,33,65,36,0,23,0,41,043,020400,4,410430204004
"Block Group 2, Census Tract 318.15, Washington County, Oregon",1267,1049,218,1267,42,1225,1267,127,0,0,98,0,32,31,29,40,44,78,173,167,151,114,183,41,067,031815,2,410670318152
"Block Group 1, Census Tract 27, Marion County, Oregon",1146,861,285,1146,95,1051,1146,6,11,36,18,7,24,56,37,45,54,48,253,126,169,204,52,41,047,002700,1,410470027001
"Block Group 1, Census Tract 205.01, Clackamas County, Oregon",365,237,128,365,25,340,365,13,12,19,55,0,0,65,0,0,0,18,20,11,11,88,53,41,005,020501,1,410050205011
"Block Group 2, Census Tract 207, Clackamas County, Oregon",734,563,171,734,97,637,734,52,0,23,0,0,17,10,11,41,69,70,102,52,103,66,118,41,005,020700,2,410050207002
"Block Group 1, Census Tract 207, Clackamas County, Oregon",289,240,49,289,63,226,289,34,0,0,0,10,21,0,0,6,19,19,9,28,20,91,32,41,005,020700,1,410050207001
"Block Group 1, Census Tract 225, Clackamas County, Oregon",915,722,193,915,138,777,915,16,31,20,11,38,80,46,46,0,47,132,129,147,103,55,14,41,005,022500,1,410050225001
"Block Group 2, Census Tract 225, Clackamas County, Oregon",760,670,90,760,272,488,760,66,0,56,19,0,87,21,75,35,18,68,143,101,41,30,0,41,005,022500,2,410050225002
"Block Group 4, Census Tract 225, Clackamas County, Oregon",269,232,37,269,12,257,269,16,12,56,0,0,0,0,18,12,0,12,93,31,0,0,19,41,005,022500,4,410050225004
"Block Group 3, Census Tract 225, Clackamas County, Oregon",1078,943,135,1078,54,1024,1078,13,0,0,16,79,27,27,51,0,169,87,147,220,37,128,77,41,005,022500,3,410050225003
"Block Group 2, Census Tract 234.01, Clackamas County, Oregon",750,516,234,750,90,660,750,19,57,24,32,9,72,12,9,0,62,22,108,102,45,81,96,41,005,023401,2,410050234012
"Block Group 1, Census Tract 234.01, Clackamas County, Oregon",594,452,142,594,67,527,594,19,0,58,47,31,20,34,19,20,48,94,76,46,28,14,40,41,005,023401,1,410050234011
"Block Group 3, Census Tract 234.01, Clackamas County, Oregon",419,321,98,419,21,398,419,31,0,10,0,9,20,0,9,0,41,38,40,113,62,46,0,41,005,023401,3,410050234013
"Block Group 3, Census Tract 241, Clackamas County, Oregon",515,390,125,515,23,492,515,33,0,30,0,27,45,0,38,20,9,39,60,37,51,93,33,41,005,024100,3,410050241003
"Block Group 1, Census Tract 241, Clackamas County, Oregon",639,495,144,639,59,580,639,8,0,20,32,0,18,8,20,56,67,56,81,74,89,52,58,41,005,024100,1,410050241001
"Block Group 1, Census Tract 206, Clackamas County, Oregon",682,559,123,682,34,648,682,14,0,0,0,0,34,16,102,18,65,29,144,43,92,62,63,41,005,020600,1,410050206001
"Block Group 3, Census Tract 206, Clackamas County, Oregon",1204,1053,151,1204,63,1141,1204,20,19,0,66,54,72,0,24,0,98,142,101,96,83,123,306,41,005,020600,3,410050206003
"Block Group 1, Census Tract 203.03, Clackamas County, Oregon",1038,1002,36,1038,52,986,1038,34,0,35,23,0,52,68,17,58,22,120,143,88,58,189,131,41,005,020303,1,410050203031
"Block Group 2, Census Tract 208, Clackamas County, Oregon",419,378,41,419,60,359,419,11,0,8,27,9,72,30,9,0,46,49,77,53,9,19,0,41,005,020800,2,410050208002
"Block Group 3, Census Tract 208, Clackamas County, Oregon",844,663,181,844,56,788,844,40,8,35,70,17,44,76,66,67,91,64,116,68,36,17,29,41,005,020800,3,410050208003
"Block Group 2, Census Tract 221.01, Clackamas County, Oregon",465,339,126,465,33,432,465,0,0,0,19,19,34,20,18,0,29,18,107,15,90,37,59,41,005,022101,2,410050221012
"Block Group 1, Census Tract 221.01, Clackamas County, Oregon",942,712,230,942,242,700,942,44,21,55,0,53,18,22,13,19,124,153,49,102,119,122,28,41,005,022101,1,410050221011
"Block Group 2, Census Tract 9716, Klamath County, Oregon",377,182,195,377,223,154,377,26,50,64,60,10,24,31,22,9,57,0,0,10,0,14,0,41,035,971600,2,410359716002
"Block Group 3, Census Tract 9716, Klamath County, Oregon",535,399,136,535,264,271,535,51,58,80,45,45,62,0,76,0,82,0,36,0,0,0,0,41,035,971600,3,410359716003
"Block Group 3, Census Tract 9712, Klamath County, Oregon",232,153,79,232,48,184,232,26,0,33,16,11,21,54,0,24,3,7,29,8,0,0,0,41,035,971200,3,410359712003
"Block Group 2, Census Tract 9712, Klamath County, Oregon",296,220,76,296,138,158,296,10,28,18,19,41,22,26,26,7,28,50,13,8,0,0,0,41,035,971200,2,410359712002
"Block Group 6, Census Tract 9713, Klamath County, Oregon",324,247,77,324,71,253,324,14,15,14,19,42,27,15,14,14,21,43,68,18,0,0,0,41,035,971300,6,410359713006
"Block Group 3, Census Tract 9713, Klamath County, Oregon",361,239,122,361,203,158,361,64,13,112,18,16,61,16,17,13,16,0,15,0,0,0,0,41,035,971300,3,410359713003
"Block Group 1, Census Tract 9713, Klamath County, Oregon",200,100,100,200,58,142,200,56,20,28,18,0,0,16,15,17,0,0,30,0,0,0,0,41,035,971300,1,410359713001
"Block Group 5, Census Tract 9713, Klamath County, Oregon",798,377,421,798,112,686,798,36,31,48,0,0,32,59,73,0,110,56,211,80,30,32,0,41,035,971300,5,410359713005
"Block Group 2, Census Tract 9709, Klamath County, Oregon",594,403,191,594,165,429,594,102,33,26,22,33,61,58,19,0,30,65,47,34,10,54,0,41,035,970900,2,410359709002
"Block Group 1, Census Tract 9709, Klamath County, Oregon",925,676,249,925,70,855,925,34,10,10,0,48,10,46,16,36,46,127,109,92,185,68,88,41,035,970900,1,410359709001
"Block Group 1, Census Tract 9719, Klamath County, Oregon",314,210,104,314,135,179,314,0,0,41,68,8,18,8,15,0,50,46,34,0,26,0,0,41,035,971900,1,410359719001
"Block Group 4, Census Tract 9719, Klamath County, Oregon",475,366,109,475,222,253,475,51,92,43,14,45,9,9,74,29,25,0,37,47,0,0,0,41,035,971900,4,410359719004
"Block Group 2, Census Tract 42, Multnomah County, Oregon",1263,1033,230,1263,209,1054,1263,103,48,8,78,79,28,0,91,88,172,56,146,166,67,93,40,41,051,004200,2,410510042002
"Block Group 3, Census Tract 47, Multnomah County, Oregon",1039,971,68,1039,176,863,1039,91,42,67,77,57,84,9,91,68,65,46,0,52,61,78,151,41,051,004700,3,410510047003
"Block Group 2, Census Tract 47, Multnomah County, Oregon",753,645,108,753,55,698,753,43,21,17,69,16,69,31,8,62,105,0,42,105,29,44,92,41,051,004700,2,410510047002
"Block Group 1, Census Tract 47, Multnomah County, Oregon",793,725,68,793,19,774,793,13,0,0,17,24,17,14,42,0,58,50,13,71,83,108,283,41,051,004700,1,410510047001
"Block Group 2, Census Tract 65.02, Multnomah County, Oregon",897,761,136,897,85,812,897,63,14,0,68,21,0,39,25,0,28,17,211,50,175,54,132,41,051,006502,2,410510065022
"Block Group 1, Census Tract 65.02, Multnomah County, Oregon",1202,936,266,1202,236,966,1202,182,16,48,22,47,31,44,77,13,64,125,199,87,140,43,64,41,051,006502,1,410510065021
"Block Group 1, Census Tract 68.02, Multnomah County, Oregon",598,500,98,598,10,588,598,0,0,17,0,0,7,0,0,23,8,18,30,91,36,77,291,41,051,006802,1,410510068021
"Block Group 2, Census Tract 68.02, Multnomah County, Oregon",850,695,155,850,46,804,850,31,90,8,21,29,30,12,24,27,74,31,77,29,49,165,153,41,051,006802,2,410510068022
"Block Group 1, Census Tract 75, Multnomah County, Oregon",780,660,120,780,176,604,780,71,11,10,11,0,36,9,23,0,45,134,230,101,18,43,38,41,051,007500,1,410510075001
"Block Group 3, Census Tract 75, Multnomah County, Oregon",627,549,78,627,136,491,627,22,30,0,60,41,10,34,56,0,21,98,167,64,18,6,0,41,051,007500,3,410510075003
"Block Group 2, Census Tract 75, Multnomah County, Oregon",392,331,61,392,28,364,392,30,0,9,10,7,0,16,7,0,12,30,58,51,55,93,14,41,051,007500,2,410510075002
"Block Group 1, Census Tract 78, Multnomah County, Oregon",369,343,26,369,122,247,369,32,4,4,42,27,41,31,33,5,7,66,5,22,35,15,0,41,051,007800,1,410510078001
"Block Group 2, Census Tract 78, Multnomah County, Oregon",436,391,45,436,68,368,436,9,9,9,13,7,15,6,23,3,4,47,88,73,62,34,34,41,051,007800,2,410510078002
"Block Group 1, Census Tract 88, Multnomah County, Oregon",542,396,146,542,187,355,542,46,22,39,58,42,17,8,16,0,80,55,49,70,32,8,0,41,051,008800,1,410510088001
"Block Group 2, Census Tract 88, Multnomah County, Oregon",556,533,23,556,109,447,556,22,0,0,46,39,46,21,17,29,42,62,95,86,32,0,19,41,051,008800,2,410510088002
"Block Group 3, Census Tract 92.01, Multnomah County, Oregon",1024,900,124,1024,231,793,1024,85,35,29,145,22,120,42,72,0,56,46,170,57,82,53,10,41,051,009201,3,410510092013
"Block Group 1, Census Tract 98.04, Multnomah County, Oregon",701,496,205,701,230,471,701,39,44,49,17,33,29,49,10,0,30,137,81,67,96,20,0,41,051,009804,1,410510098041
"Block Group 1, Census Tract 99.03, Multnomah County, Oregon",395,300,95,395,0,395,395,21,0,14,0,0,0,20,0,0,14,47,102,79,39,39,20,41,051,009903,1,410510099031
"Block Group 4, Census Tract 316.17, Washington County, Oregon",350,350,0,350,0,350,350,0,0,0,13,0,0,0,33,0,53,13,104,45,28,18,43,41,067,031617,4,410670316174
"Block Group 3, Census Tract 316.17, Washington County, Oregon",542,525,17,542,19,523,542,0,0,0,9,40,8,0,54,30,0,105,142,42,62,25,25,41,067,031617,3,410670316173
"Block Group 2, Census Tract 316.17, Washington County, Oregon",760,686,74,760,97,663,760,48,0,29,12,18,0,8,15,15,52,63,158,171,43,76,52,41,067,031617,2,410670316172
"Block Group 1, Census Tract 316.17, Washington County, Oregon",649,629,20,649,10,639,649,0,0,0,11,0,37,34,0,13,65,35,199,149,71,18,17,41,067,031617,1,410670316171
"Block Group 1, Census Tract 321.10, Washington County, Oregon",672,588,84,672,28,644,672,45,0,0,29,8,8,46,20,0,45,74,195,61,72,10,59,41,067,032110,1,410670321101
"Block Group 1, Census Tract 4.06, Jackson County, Oregon",926,495,431,926,160,766,926,63,44,75,27,42,71,125,159,35,91,61,42,49,21,21,0,41,029,000406,1,410290004061
"Block Group 2, Census Tract 4.06, Jackson County, Oregon",1147,990,157,1147,164,983,1147,76,42,12,54,22,21,9,84,52,60,209,251,153,72,16,14,41,029,000406,2,410290004062
"Block Group 1, Census Tract 5.02, Jackson County, Oregon",545,411,134,545,107,438,545,19,0,0,27,0,55,41,33,57,28,12,118,42,38,58,17,41,029,000502,1,410290005021
"Block Group 2, Census Tract 5.02, Jackson County, Oregon",784,545,239,784,385,399,784,231,41,18,37,84,0,65,128,26,23,71,0,37,0,0,23,41,029,000502,2,410290005022
"Block Group 3, Census Tract 5.02, Jackson County, Oregon",1125,675,450,1125,500,625,1125,206,70,123,297,188,24,24,57,23,44,12,44,0,0,0,13,41,029,000502,3,410290005023
"Block Group 2, Census Tract 10.02, Jackson County, Oregon",382,304,78,382,52,330,382,14,33,6,10,20,30,23,16,51,9,49,38,9,74,0,0,41,029,001002,2,410290010022
"Block Group 1, Census Tract 10.02, Jackson County, Oregon",1054,919,135,1054,232,822,1054,16,21,27,29,36,57,38,65,73,122,58,277,129,34,34,38,41,029,001002,1,410290010021
"Block Group 3, Census Tract 10.02, Jackson County, Oregon",298,202,96,298,130,168,298,75,17,0,16,41,8,0,50,31,7,9,35,0,0,0,9,41,029,001002,3,410290010023
"Block Group 1, Census Tract 4.04, Jackson County, Oregon",884,564,320,884,51,833,884,7,15,19,69,31,45,47,25,11,74,47,194,77,95,94,34,41,029,000404,1,410290004041
"Block Group 2, Census Tract 4.04, Jackson County, Oregon",876,671,205,876,41,835,876,31,41,28,18,0,9,104,0,34,38,109,158,102,61,94,49,41,029,000404,2,410290004042
"Block Group 3, Census Tract 16.02, Jackson County, Oregon",206,190,16,206,0,206,206,0,0,0,0,0,0,46,16,0,0,49,39,0,41,15,0,41,029,001602,3,410290016023
"Block Group 5, Census Tract 16.02, Jackson County, Oregon",874,555,319,874,170,704,874,86,20,140,141,32,16,41,30,0,37,113,104,37,14,63,0,41,029,001602,5,410290016025
"Block Group 1, Census Tract 16.01, Jackson County, Oregon",1489,1031,458,1489,529,960,1489,59,59,112,160,158,105,93,68,118,180,152,164,34,9,18,0,41,029,001601,1,410290016011
"Block Group 2, Census Tract 5.01, Jackson County, Oregon",806,674,132,806,149,657,806,22,29,9,67,78,0,64,20,80,48,87,122,88,34,37,21,41,029,000501,2,410290005012
"Block Group 1, Census Tract 5.01, Jackson County, Oregon",568,464,104,568,134,434,568,31,22,88,69,18,19,80,21,64,13,49,89,0,0,5,0,41,029,000501,1,410290005011
"Block Group 2, Census Tract 4.03, Jackson County, Oregon",279,224,55,279,0,279,279,0,0,0,0,10,27,0,34,17,11,64,47,14,11,20,24,41,029,000403,2,410290004032
"Block Group 2, Census Tract 4.05, Jackson County, Oregon",1076,800,276,1076,316,760,1076,52,79,60,57,0,127,45,78,38,166,73,224,36,17,24,0,41,029,000405,2,410290004052
"Block Group 1, Census Tract 316.14, Washington County, Oregon",670,620,50,670,71,599,670,8,0,10,0,27,20,0,9,14,37,42,104,142,113,96,48,41,067,031614,1,410670316141
"Block Group 1, Census Tract 324.07, Washington County, Oregon",855,793,62,855,76,779,855,0,7,0,35,44,30,42,14,14,50,69,164,94,76,104,112,41,067,032407,1,410670324071
"Block Group 2, Census Tract 321.08, Washington County, Oregon",571,526,45,571,22,549,571,0,0,9,13,0,10,8,21,31,63,65,102,98,73,32,46,41,067,032108,2,410670321082
"Block Group 3, Census Tract 321.08, Washington County, Oregon",492,470,22,492,0,492,492,0,0,0,0,12,0,0,0,26,33,6,51,84,89,116,75,41,067,032108,3,410670321083
"Block Group 4, Census Tract 333.01, Washington County, Oregon",224,156,68,224,34,190,224,0,0,16,13,0,0,8,25,11,17,11,71,18,24,0,10,41,067,033301,4,410670333014
"Block Group 3, Census Tract 18.01, Lane County, Oregon",518,387,131,518,18,500,518,14,40,0,39,6,0,38,0,16,74,82,111,61,19,5,13,41,039,001801,3,410390018013
"Block Group 3, Census Tract 32.02, Lane County, Oregon",791,680,111,791,299,492,791,139,42,19,32,76,68,36,44,10,62,84,88,54,19,0,18,41,039,003202,3,410390032023
"Block Group 2, Census Tract 9400, Umatilla County, Oregon",677,473,204,677,180,497,677,58,53,45,71,26,29,28,19,25,44,48,94,49,36,36,16,41,059,940000,2,410599400002
"Block Group 2, Census Tract 222.07, Clackamas County, Oregon",521,443,78,521,18,503,521,0,9,0,0,0,6,9,8,9,38,12,40,92,17,109,172,41,005,022207,2,410050222072
"Block Group 1, Census Tract 223.01, Clackamas County, Oregon",600,457,143,600,15,585,600,0,0,0,17,15,39,26,0,9,30,76,50,88,121,65,64,41,005,022301,1,410050223011
"Block Group 2, Census Tract 223.01, Clackamas County, Oregon",576,383,193,576,33,543,576,11,21,28,11,8,6,6,37,0,33,101,100,29,81,70,34,41,005,022301,2,410050223012
"Block Group 1, Census Tract 227.08, Clackamas County, Oregon",519,465,54,519,0,519,519,0,0,9,0,0,10,0,28,0,10,24,50,49,43,131,165,41,005,022708,1,410050227081
"Block Group 2, Census Tract 227.08, Clackamas County, Oregon",1038,873,165,1038,90,948,1038,70,9,56,13,20,71,46,44,6,94,142,73,31,101,83,179,41,005,022708,2,410050227082
"Block Group 2, Census Tract 223.02, Clackamas County, Oregon",680,460,220,680,45,635,680,20,37,0,16,0,84,68,89,0,62,60,57,32,68,38,49,41,005,022302,2,410050223022
"Block Group 3, Census Tract 223.02, Clackamas County, Oregon",813,679,134,813,173,640,813,51,56,0,19,93,72,0,50,0,33,72,137,78,100,32,20,41,005,022302,3,410050223023
"Block Group 3, Census Tract 226.05, Clackamas County, Oregon",1035,858,177,1035,71,964,1035,0,20,0,16,30,18,32,27,37,10,237,185,64,108,63,188,41,005,022605,3,410050226053
"Block Group 3, Census Tract 9719, Klamath County, Oregon",235,177,58,235,98,137,235,22,9,0,0,9,50,0,0,66,34,0,10,18,7,10,0,41,035,971900,3,410359719003
"Block Group 4, Census Tract 9720, Klamath County, Oregon",362,159,203,362,10,352,362,61,10,62,8,5,8,37,0,0,5,35,76,5,28,0,22,41,035,972000,4,410359720004
"Block Group 1, Census Tract 9720, Klamath County, Oregon",359,295,64,359,91,268,359,0,36,30,16,0,42,0,14,0,37,49,79,17,37,2,0,41,035,972000,1,410359720001
"Block Group 1, Census Tract 2, Marion County, Oregon",325,280,45,325,45,280,325,12,6,30,0,0,6,9,47,0,41,30,56,7,64,8,9,41,047,000200,1,410470002001
"Block Group 2, Census Tract 2, Marion County, Oregon",408,362,46,408,50,358,408,47,19,24,0,8,31,0,54,18,58,9,16,38,31,11,44,41,047,000200,2,410470002002
"Block Group 3, Census Tract 3, Marion County, Oregon",502,446,56,502,125,377,502,8,99,107,37,27,34,19,2,39,33,6,48,10,23,0,10,41,047,000300,3,410470003003
"Block Group 2, Census Tract 3, Marion County, Oregon",355,342,13,355,45,310,355,29,0,14,33,55,9,15,42,0,42,0,40,50,14,0,12,41,047,000300,2,410470003002
"Block Group 4, Census Tract 3, Marion County, Oregon",507,334,173,507,104,403,507,43,17,54,5,39,65,17,18,38,19,95,60,25,0,0,12,41,047,000300,4,410470003004
"Block Group 2, Census Tract 12, Marion County, Oregon",845,616,229,845,246,599,845,60,79,32,25,53,32,80,28,27,68,78,110,57,44,14,58,41,047,001200,2,410470012002
"Block Group 3, Census Tract 9, Marion County, Oregon",289,233,56,289,76,213,289,24,0,28,15,14,29,0,0,0,58,100,21,0,0,0,0,41,047,000900,3,410470009003
"Block Group 3, Census Tract 1, Coos County, Oregon",585,329,256,585,7,578,585,16,47,7,89,50,41,62,0,38,33,36,32,21,24,31,58,41,011,000100,3,410110001003
"Block Group 4, Census Tract 1, Coos County, Oregon",330,228,102,330,194,136,330,43,0,15,55,0,0,58,0,32,66,0,14,0,0,33,14,41,011,000100,4,410110001004
"Block Group 2, Census Tract 1, Coos County, Oregon",359,206,153,359,88,271,359,0,21,21,23,45,12,6,51,0,38,48,79,15,0,0,0,41,011,000100,2,410110001002
"Block Group 6, Census Tract 1, Coos County, Oregon",386,215,171,386,33,353,386,18,0,31,16,17,17,18,18,0,19,67,19,84,24,24,14,41,011,000100,6,410110001006
"Block Group 1, Census Tract 1, Coos County, Oregon",516,141,375,516,113,403,516,40,49,23,15,53,43,51,68,0,52,49,44,15,6,0,8,41,011,000100,1,410110001001
"Block Group 5, Census Tract 1, Coos County, Oregon",313,204,109,313,54,259,313,0,16,38,19,0,0,58,32,17,17,30,57,15,0,14,0,41,011,000100,5,410110001005
"Block Group 4, Census Tract 13.01, Multnomah County, Oregon",647,562,85,647,63,584,647,38,18,8,8,32,18,30,35,32,43,56,121,71,46,54,37,41,051,001301,4,410510013014
"Block Group 2, Census Tract 13.01, Multnomah County, Oregon",344,328,16,344,39,305,344,32,0,8,8,8,18,17,0,0,34,20,17,40,22,56,64,41,051,001301,2,410510013012
"Block Group 3, Census Tract 13.01, Multnomah County, Oregon",440,400,40,440,24,416,440,7,8,0,0,0,29,15,10,13,41,66,30,26,60,62,73,41,051,001301,3,410510013013
"Block Group 2, Census Tract 14, Multnomah County, Oregon",628,541,87,628,43,585,628,0,0,25,18,61,14,30,26,0,30,141,115,30,58,47,33,41,051,001400,2,410510014002
"Block Group 1, Census Tract 14, Multnomah County, Oregon",691,475,216,691,122,569,691,118,0,0,16,16,20,63,18,12,28,50,86,114,97,20,33,41,051,001400,1,410510014001
"Block Group 5, Census Tract 14, Multnomah County, Oregon",293,293,0,293,84,209,293,30,0,50,0,4,0,0,0,0,18,36,29,11,18,62,35,41,051,001400,5,410510014005
"Block Group 3, Census Tract 14, Multnomah County, Oregon",590,529,61,590,57,533,590,22,0,24,0,39,0,39,0,19,21,35,64,15,72,160,80,41,051,001400,3,410510014003
"Block Group 4, Census Tract 14, Multnomah County, Oregon",371,292,79,371,50,321,371,13,0,0,0,18,0,0,19,0,81,47,71,23,34,65,0,41,051,001400,4,410510014004
"Block Group 4, Census Tract 25.02, Multnomah County, Oregon",562,479,83,562,18,544,562,24,0,0,39,0,0,34,21,0,47,39,99,122,21,10,106,41,051,002502,4,410510025024
"Block Group 3, Census Tract 25.02, Multnomah County, Oregon",904,765,139,904,155,749,904,91,0,49,0,122,0,52,57,0,148,101,52,22,97,33,80,41,051,002502,3,410510025023
"Block Group 3, Census Tract 27.01, Multnomah County, Oregon",295,274,21,295,18,277,295,0,0,0,0,0,6,0,5,0,3,17,50,24,39,51,100,41,051,002701,3,410510027013
"Block Group 1, Census Tract 27.01, Multnomah County, Oregon",428,373,55,428,0,428,428,0,9,0,0,10,0,21,0,0,17,13,34,51,106,37,130,41,051,002701,1,410510027011
"Block Group 1, Census Tract 13.01, Multnomah County, Oregon",507,463,44,507,29,478,507,53,0,15,0,18,0,0,24,15,40,75,75,85,48,44,15,41,051,001301,1,410510013011
"Block Group 1, Census Tract 37.01, Multnomah County, Oregon",477,361,116,477,8,469,477,29,44,0,0,41,24,16,32,19,44,50,52,62,35,29,0,41,051,003701,1,410510037011
"Block Group 4, Census Tract 39.02, Multnomah County, Oregon",365,317,48,365,0,365,365,7,0,0,21,0,0,0,0,0,44,0,90,34,72,70,27,41,051,003902,4,410510039024
"Block Group 2, Census Tract 39.02, Multnomah County, Oregon",394,353,41,394,97,297,394,24,0,20,40,0,0,0,62,11,9,0,68,22,18,37,83,41,051,003902,2,410510039022
"Block Group 3, Census Tract 39.02, Multnomah County, Oregon",341,294,47,341,8,333,341,18,0,0,9,10,8,0,7,9,10,42,87,35,9,70,27,41,051,003902,3,410510039023
"Block Group 2, Census Tract 48, Multnomah County, Oregon",737,611,126,737,132,605,737,146,73,71,53,40,0,13,82,18,33,48,38,15,74,33,0,41,051,004800,2,410510048002
"Block Group 2, Census Tract 49, Multnomah County, Oregon",870,591,279,870,257,613,870,159,37,37,88,58,59,59,0,88,41,22,111,22,65,24,0,41,051,004900,2,410510049002
"Block Group 2, Census Tract 67.02, Multnomah County, Oregon",503,361,142,503,0,503,503,0,0,7,27,19,8,16,31,15,17,48,77,25,50,103,60,41,051,006702,2,410510067022
"Block Group 4, Census Tract 105, Multnomah County, Oregon",324,289,35,324,0,324,324,0,18,12,6,14,9,39,33,0,24,39,40,26,34,11,19,41,051,010500,4,410510105004
"Block Group 2, Census Tract 105, Multnomah County, Oregon",407,388,19,407,6,401,407,0,6,10,0,0,23,20,10,18,10,30,118,0,77,61,24,41,051,010500,2,410510105002
"Block Group 3, Census Tract 105, Multnomah County, Oregon",389,271,118,389,37,352,389,33,8,0,0,0,9,16,12,22,52,71,75,0,20,22,49,41,051,010500,3,410510105003
"Block Group 3, Census Tract 95.02, Multnomah County, Oregon",740,613,127,740,114,626,740,27,96,74,36,53,46,40,53,21,64,91,40,67,0,8,24,41,051,009502,3,410510095023
"Block Group 1, Census Tract 95.02, Multnomah County, Oregon",460,371,89,460,34,426,460,4,10,0,0,15,8,0,5,22,57,27,94,89,30,16,83,41,051,009502,1,410510095021
"Block Group 2, Census Tract 104.07, Multnomah County, Oregon",648,404,244,648,124,524,648,17,50,40,33,32,45,64,53,33,53,45,67,60,31,25,0,41,051,010407,2,410510104072
"Block Group 3, Census Tract 104.07, Multnomah County, Oregon",392,319,73,392,119,273,392,16,0,7,59,0,0,16,14,38,34,26,118,32,8,24,0,41,051,010407,3,410510104073
"Block Group 4, Census Tract 20, Multnomah County, Oregon",892,828,64,892,53,839,892,52,16,13,14,48,0,63,50,50,67,78,165,78,74,65,59,41,051,002000,4,410510020004
"Block Group 3, Census Tract 20, Multnomah County, Oregon",881,868,13,881,64,817,881,18,24,52,0,64,0,39,161,34,111,39,153,53,15,66,52,41,051,002000,3,410510020003
"Block Group 2, Census Tract 317.03, Washington County, Oregon",409,313,96,409,16,393,409,33,0,33,28,15,10,7,7,0,22,60,95,29,27,36,7,41,067,031703,2,410670317032
"Block Group 2, Census Tract 313, Washington County, Oregon",915,741,174,915,110,805,915,96,61,17,61,16,52,46,14,0,43,135,101,113,17,69,74,41,067,031300,2,410670313002
"Block Group 2, Census Tract 320.01, Washington County, Oregon",309,181,128,309,0,309,309,0,0,0,0,0,0,13,13,16,14,12,73,48,36,11,73,41,067,032001,2,410670320012
"Block Group 2, Census Tract 20, Multnomah County, Oregon",397,384,13,397,41,356,397,0,0,0,0,31,22,0,24,0,15,41,15,102,22,27,98,41,051,002000,2,410510020002
"Block Group 1, Census Tract 31, Multnomah County, Oregon",673,602,71,673,79,594,673,51,9,13,17,22,0,24,0,0,64,49,140,41,46,94,103,41,051,003100,1,410510031001
"Block Group 4, Census Tract 31, Multnomah County, Oregon",333,284,49,333,8,325,333,0,0,0,0,8,15,9,8,0,9,0,0,39,20,40,185,41,051,003100,4,410510031004
"Block Group 1, Census Tract 46.02, Multnomah County, Oregon",487,396,91,487,6,481,487,0,0,0,6,5,18,23,15,12,35,54,12,35,30,63,179,41,051,004602,1,410510046021
"Block Group 1, Census Tract 69, Multnomah County, Oregon",636,553,83,636,0,636,636,7,0,0,0,35,0,13,7,0,17,60,58,37,36,139,227,41,051,006900,1,410510069001
"Block Group 2, Census Tract 30, Multnomah County, Oregon",534,497,37,534,44,490,534,25,10,8,0,0,10,28,19,20,13,49,50,44,61,151,46,41,051,003000,2,410510030002
"Block Group 4, Census Tract 30, Multnomah County, Oregon",343,261,82,343,0,343,343,0,0,0,25,7,0,0,22,0,8,13,50,99,56,20,43,41,051,003000,4,410510030004
"Block Group 3, Census Tract 30, Multnomah County, Oregon",599,562,37,599,16,583,599,0,18,0,0,0,0,9,0,9,22,49,116,168,57,54,97,41,051,003000,3,410510030003
"Block Group 2, Census Tract 83.01, Multnomah County, Oregon",953,839,114,953,359,594,953,68,62,36,31,84,62,66,47,31,55,66,166,75,32,37,35,41,051,008301,2,410510083012
"Block Group 1, Census Tract 100.01, Multnomah County, Oregon",535,436,99,535,270,265,535,14,97,15,34,39,83,77,20,0,29,74,38,0,0,15,0,41,051,010001,1,410510100011
"Block Group 2, Census Tract 335, Washington County, Oregon",974,877,97,974,67,907,974,14,0,3,5,8,24,15,40,34,86,68,150,203,134,99,91,41,067,033500,2,410670335002
"Block Group 2, Census Tract 304.01, Washington County, Oregon",907,749,158,907,57,850,907,23,0,42,0,15,12,26,125,57,74,26,68,55,130,67,187,41,067,030401,2,410670304012
"Block Group 1, Census Tract 305.02, Washington County, Oregon",763,644,119,763,50,713,763,34,0,8,8,37,58,42,0,15,31,36,121,89,86,89,109,41,067,030502,1,410670305021
"Block Group 1, Census Tract 312, Washington County, Oregon",663,556,107,663,110,553,663,35,32,0,61,0,41,35,66,27,120,82,47,13,59,22,23,41,067,031200,1,410670312001
"Block Group 3, Census Tract 103.05, Multnomah County, Oregon",380,339,41,380,29,351,380,6,10,12,0,0,23,5,18,0,53,42,72,67,53,19,0,41,051,010305,3,410510103053
"Block Group 2, Census Tract 103.05, Multnomah County, Oregon",574,502,72,574,23,551,574,7,0,6,0,0,0,28,6,0,32,77,132,94,107,61,24,41,051,010305,2,410510103052
"Block Group 1, Census Tract 103.05, Multnomah County, Oregon",514,365,149,514,60,454,514,22,42,0,67,20,13,41,46,0,49,75,58,63,8,0,10,41,051,010305,1,410510103051
"Block Group 2, Census Tract 97.02, Multnomah County, Oregon",722,616,106,722,303,419,722,62,15,0,54,30,19,58,61,16,52,93,118,128,0,5,11,41,051,009702,2,410510097022
"Block Group 1, Census Tract 97.02, Multnomah County, Oregon",803,717,86,803,105,698,803,96,14,15,15,15,99,38,36,37,171,93,0,46,58,17,53,41,051,009702,1,410510097021
"Block Group 4, Census Tract 97.02, Multnomah County, Oregon",809,495,314,809,342,467,809,99,52,78,15,65,45,29,82,43,31,117,87,19,47,0,0,41,051,009702,4,410510097024
"Block Group 3, Census Tract 97.02, Multnomah County, Oregon",362,331,31,362,64,298,362,0,44,0,0,0,10,53,20,25,104,36,17,53,0,0,0,41,051,009702,3,410510097023
"Block Group 1, Census Tract 98.03, Multnomah County, Oregon",866,731,135,866,337,529,866,44,72,0,32,0,14,74,102,29,18,77,189,84,58,49,24,41,051,009803,1,410510098031
"Block Group 2, Census Tract 98.03, Multnomah County, Oregon",578,536,42,578,165,413,578,117,0,66,0,0,0,50,0,49,60,92,78,33,14,19,0,41,051,009803,2,410510098032
"Block Group 1, Census Tract 103.04, Multnomah County, Oregon",759,690,69,759,325,434,759,65,23,21,41,19,62,28,47,0,91,139,144,35,33,11,0,41,051,010304,1,410510103041
"Block Group 2, Census Tract 103.04, Multnomah County, Oregon",521,474,47,521,122,399,521,22,0,22,47,14,15,31,0,32,129,16,63,62,21,17,30,41,051,010304,2,410510103042
"Block Group 1, Census Tract 74, Multnomah County, Oregon",468,320,148,468,203,265,468,104,85,17,31,10,33,24,26,0,29,9,39,8,18,28,7,41,051,007400,1,410510074001
"Block Group 1, Census Tract 304.02, Washington County, Oregon",812,650,162,812,65,747,812,17,18,17,32,0,46,0,17,95,10,70,135,79,88,61,127,41,067,030402,1,410670304021
"Block Group 3, Census Tract 305.01, Washington County, Oregon",768,640,128,768,122,646,768,15,41,69,10,12,40,60,135,0,73,0,35,138,49,91,0,41,067,030501,3,410670305013
"Block Group 1, Census Tract 305.01, Washington County, Oregon",434,237,197,434,35,399,434,0,82,13,27,0,11,0,28,23,0,38,41,50,35,71,15,41,067,030501,1,410670305011
"Block Group 3, Census Tract 38, Lane County, Oregon",860,830,30,860,239,621,860,475,0,124,39,19,35,24,34,69,19,22,0,0,0,0,0,41,039,003800,3,410390038003
"Block Group 3, Census Tract 42, Lane County, Oregon",486,440,46,486,146,340,486,26,69,50,96,9,42,63,34,11,0,25,0,26,35,0,0,41,039,004200,3,410390042003
"Block Group 2, Census Tract 42, Lane County, Oregon",435,310,125,435,144,291,435,39,77,35,37,8,0,28,22,41,63,30,19,10,0,26,0,41,039,004200,2,410390042002
"Block Group 1, Census Tract 42, Lane County, Oregon",626,499,127,626,307,319,626,68,64,17,23,83,73,18,85,22,84,24,54,11,0,0,0,41,039,004200,1,410390042001
"Block Group 1, Census Tract 226.05, Clackamas County, Oregon",586,467,119,586,80,506,586,20,0,46,46,63,17,0,56,37,65,112,35,38,0,51,0,41,005,022605,1,410050226051
"Block Group 2, Census Tract 227.07, Clackamas County, Oregon",2258,1838,420,2258,219,2039,2258,158,142,65,20,25,47,28,44,41,113,226,178,356,204,278,333,41,005,022707,2,410050227072
"Block Group 1, Census Tract 82.01, Multnomah County, Oregon",504,189,315,504,124,380,504,53,61,43,25,23,15,35,34,15,27,16,76,74,7,0,0,41,051,008201,1,410510082011
"Block Group 1, Census Tract 38.03, Multnomah County, Oregon",558,453,105,558,19,539,558,16,0,12,26,0,0,9,7,10,61,100,49,73,71,46,78,41,051,003803,1,410510038031
"Block Group 2, Census Tract 46.01, Multnomah County, Oregon",682,588,94,682,13,669,682,14,19,7,0,0,8,39,46,25,24,53,59,37,23,70,258,41,051,004601,2,410510046012
"Block Group 1, Census Tract 46.01, Multnomah County, Oregon",849,620,229,849,0,849,849,40,12,7,23,6,0,12,0,23,23,74,40,92,28,59,410,41,051,004601,1,410510046011
"Block Group 3, Census Tract 63, Multnomah County, Oregon",659,608,51,659,34,625,659,19,23,0,0,23,22,22,10,32,44,44,57,64,119,115,65,41,051,006300,3,410510063003
"Block Group 2, Census Tract 102, Multnomah County, Oregon",878,666,212,878,163,715,878,82,36,0,0,124,117,114,114,75,55,71,78,0,12,0,0,41,051,010200,2,410510102002
"Block Group 2, Census Tract 32, Multnomah County, Oregon",436,382,54,436,18,418,436,8,8,8,23,20,15,19,0,8,32,49,55,50,50,18,73,41,051,003200,2,410510032002
"Block Group 4, Census Tract 32, Multnomah County, Oregon",576,481,95,576,0,576,576,22,13,9,7,0,8,0,0,57,21,25,47,95,19,69,184,41,051,003200,4,410510032004
"Block Group 1, Census Tract 33.02, Multnomah County, Oregon",500,449,51,500,78,422,500,9,12,31,5,24,0,21,16,9,21,35,80,62,30,52,93,41,051,003302,1,410510033021
"Block Group 4, Census Tract 34.01, Multnomah County, Oregon",495,366,129,495,210,285,495,24,121,59,12,10,0,12,0,27,47,33,11,21,47,50,21,41,051,003401,4,410510034014
"Block Group 1, Census Tract 34.01, Multnomah County, Oregon",416,363,53,416,0,416,416,9,0,0,0,0,44,0,0,46,34,15,102,49,31,55,31,41,051,003401,1,410510034011
"Block Group 2, Census Tract 34.01, Multnomah County, Oregon",433,421,12,433,59,374,433,20,36,0,20,0,11,0,0,11,30,10,96,40,42,64,53,41,051,003401,2,410510034012
"Block Group 3, Census Tract 3.02, Multnomah County, Oregon",349,295,54,349,0,349,349,0,0,0,0,0,27,0,21,10,39,14,76,15,60,37,50,41,051,000302,3,410510003023
"Block Group 3, Census Tract 7, Deschutes County, Oregon",447,265,182,447,30,417,447,11,19,0,0,0,71,11,0,0,52,82,64,17,30,73,17,41,017,000700,3,410170007003
"Block Group 4, Census Tract 8, Deschutes County, Oregon",331,232,99,331,75,256,331,44,60,0,11,0,12,14,0,15,25,67,0,0,29,54,0,41,017,000800,4,410170008004
"Block Group 1, Census Tract 8, Deschutes County, Oregon",1690,1264,426,1690,233,1457,1690,62,26,41,15,59,32,104,87,127,60,154,405,281,167,22,48,41,017,000800,1,410170008001
"Block Group 2, Census Tract 8, Deschutes County, Oregon",451,221,230,451,148,303,451,137,40,54,20,0,26,22,32,35,0,19,15,38,0,0,13,41,017,000800,2,410170008002
"Block Group 3, Census Tract 8, Deschutes County, Oregon",356,312,44,356,77,279,356,0,48,0,14,61,15,0,0,67,66,0,41,18,0,26,0,41,017,000800,3,410170008003
"Block Group 4, Census Tract 9, Jackson County, Oregon",1747,1430,317,1747,357,1390,1747,68,78,128,149,38,96,70,12,79,172,115,366,157,116,15,88,41,029,000900,4,410290009004
"Block Group 3, Census Tract 14, Jackson County, Oregon",1718,1251,467,1718,276,1442,1718,142,35,36,108,101,98,137,27,0,131,62,446,133,184,78,0,41,029,001400,3,410290014003
"Block Group 2, Census Tract 321.10, Washington County, Oregon",308,284,24,308,0,308,308,0,0,0,0,21,10,0,5,6,0,16,18,45,61,36,90,41,067,032110,2,410670321102
"Block Group 1, Census Tract 321.09, Washington County, Oregon",335,279,56,335,15,320,335,0,0,0,6,0,14,0,5,0,14,7,24,68,16,73,108,41,067,032109,1,410670321091
"Block Group 2, Census Tract 321.09, Washington County, Oregon",691,630,61,691,11,680,691,7,0,5,6,5,3,4,0,0,7,10,56,105,85,171,227,41,067,032109,2,410670321092
"Block Group 3, Census Tract 320.03, Washington County, Oregon",300,224,76,300,17,283,300,48,0,0,9,9,9,28,43,27,78,18,8,8,8,7,0,41,067,032003,3,410670320033
"Block Group 1, Census Tract 320.03, Washington County, Oregon",960,762,198,960,277,683,960,142,10,18,74,35,89,59,41,17,85,69,113,126,43,27,12,41,067,032003,1,410670320031
"Block Group 2, Census Tract 320.03, Washington County, Oregon",776,588,188,776,150,626,776,37,13,137,69,61,68,34,50,67,55,54,46,32,33,20,0,41,067,032003,2,410670320032
"Block Group 2, Census Tract 320.04, Washington County, Oregon",399,329,70,399,23,376,399,5,8,29,27,5,5,40,5,14,20,54,75,33,32,30,17,41,067,032004,2,410670320042
"Block Group 1, Census Tract 320.04, Washington County, Oregon",433,365,68,433,23,410,433,21,6,0,5,11,17,20,9,15,12,40,103,38,47,67,22,41,067,032004,1,410670320041
"Block Group 1, Census Tract 319.10, Washington County, Oregon",1499,1368,131,1499,142,1357,1499,0,31,0,0,17,0,41,42,79,71,129,175,214,110,253,337,41,067,031910,1,410670319101
"Block Group 2, Census Tract 319.10, Washington County, Oregon",576,510,66,576,19,557,576,0,0,29,0,0,0,12,13,0,0,0,67,64,92,177,122,41,067,031910,2,410670319102
"Block Group 1, Census Tract 308.05, Washington County, Oregon",498,460,38,498,34,464,498,0,0,28,14,0,7,6,0,13,29,27,88,79,61,53,93,41,067,030805,1,410670308051
"Block Group 3, Census Tract 308.05, Washington County, Oregon",866,666,200,866,123,743,866,62,46,34,84,36,69,42,67,22,9,51,85,36,96,55,72,41,067,030805,3,410670308053
"Block Group 1, Census Tract 319.07, Washington County, Oregon",686,601,85,686,52,634,686,0,43,21,0,0,37,0,0,0,9,93,149,67,82,86,99,41,067,031907,1,410670319071
"Block Group 5, Census Tract 319.07, Washington County, Oregon",738,632,106,738,105,633,738,63,0,32,0,76,32,0,91,0,57,71,129,54,49,49,35,41,067,031907,5,410670319075
"Block Group 2, Census Tract 9, Deschutes County, Oregon",560,497,63,560,166,394,560,16,27,15,12,35,51,17,15,30,38,175,33,80,0,16,0,41,017,000900,2,410170009002
"Block Group 3, Census Tract 9, Deschutes County, Oregon",687,548,139,687,261,426,687,31,28,72,12,57,44,15,23,0,198,56,40,18,0,73,20,41,017,000900,3,410170009003
"Block Group 2, Census Tract 18, Deschutes County, Oregon",1131,821,310,1131,189,942,1131,34,13,14,14,53,0,58,0,42,120,102,301,112,103,140,25,41,017,001800,2,410170018002
"Block Group 3, Census Tract 18, Deschutes County, Oregon",1197,867,330,1197,210,987,1197,68,32,25,130,44,33,113,78,70,109,233,176,17,0,69,0,41,017,001800,3,410170018003
"Block Group 2, Census Tract 305.01, Washington County, Oregon",534,388,146,534,27,507,534,24,17,18,48,42,7,0,11,0,22,83,54,98,16,59,35,41,067,030501,2,410670305012
"Block Group 2, Census Tract 307, Washington County, Oregon",352,305,47,352,36,316,352,49,5,18,23,30,4,11,51,32,33,25,28,0,25,15,3,41,067,030700,2,410670307002
"Block Group 1, Census Tract 315.04, Washington County, Oregon",580,408,172,580,0,580,580,33,0,16,0,17,0,16,28,16,17,15,118,56,68,112,68,41,067,031504,1,410670315041
"Block Group 2, Census Tract 315.04, Washington County, Oregon",374,307,67,374,45,329,374,21,0,0,19,0,0,52,15,0,0,16,45,71,23,58,54,41,067,031504,2,410670315042
"Block Group 1, Census Tract 315.06, Washington County, Oregon",449,342,107,449,10,439,449,15,6,0,0,5,15,18,9,6,15,27,39,26,63,129,76,41,067,031506,1,410670315061
"Block Group 2, Census Tract 315.06, Washington County, Oregon",1051,868,183,1051,147,904,1051,68,39,49,54,43,50,32,21,67,119,108,131,61,51,57,101,41,067,031506,2,410670315062
"Block Group 2, Census Tract 317.05, Washington County, Oregon",816,682,134,816,120,696,816,0,19,11,68,16,151,47,26,16,55,131,75,36,37,86,42,41,067,031705,2,410670317052
"Block Group 3, Census Tract 317.05, Washington County, Oregon",587,440,147,587,109,478,587,34,9,21,34,48,51,19,12,28,64,73,43,46,14,23,68,41,067,031705,3,410670317053
"Block Group 2, Census Tract 10.01, Lane County, Oregon",564,466,98,564,48,516,564,29,22,17,41,6,7,35,10,54,25,60,101,24,46,48,39,41,039,001001,2,410390010012
"Block Group 1, Census Tract 10.01, Lane County, Oregon",491,351,140,491,38,453,491,28,20,12,20,8,26,30,6,13,45,36,104,80,42,14,7,41,039,001001,1,410390010011
"Block Group 1, Census Tract 10.02, Lane County, Oregon",628,500,128,628,83,545,628,38,8,21,0,0,15,24,0,16,16,88,115,112,83,47,45,41,039,001002,1,410390010021
"Block Group 3, Census Tract 10.02, Lane County, Oregon",490,388,102,490,80,410,490,8,37,9,8,8,8,7,10,120,0,18,75,61,39,33,49,41,039,001002,3,410390010023
"Block Group 2, Census Tract 18.04, Lane County, Oregon",1015,747,268,1015,178,837,1015,30,31,0,45,64,106,0,26,22,50,133,161,150,72,70,55,41,039,001804,2,410390018042
"Block Group 2, Census Tract 19.02, Lane County, Oregon",261,186,75,261,110,151,261,23,0,16,0,0,0,23,23,32,13,14,77,40,0,0,0,41,039,001902,2,410390019022
"Block Group 1, Census Tract 22.01, Lane County, Oregon",592,403,189,592,17,575,592,8,0,8,14,15,7,20,8,0,49,59,57,80,16,87,164,41,039,002201,1,410390022011
"Block Group 2, Census Tract 22.01, Lane County, Oregon",1044,737,307,1044,148,896,1044,54,22,62,47,54,129,50,25,26,139,86,155,136,36,5,18,41,039,002201,2,410390022012
"Block Group 1, Census Tract 4.04, Lane County, Oregon",421,339,82,421,0,421,421,0,0,0,27,41,8,21,0,47,9,63,66,26,0,32,81,41,039,000404,1,410390004041
"Block Group 3, Census Tract 4.04, Lane County, Oregon",629,446,183,629,175,454,629,26,46,26,39,21,26,29,0,36,97,75,93,18,18,64,15,41,039,000404,3,410390004043
"Block Group 1, Census Tract 7.02, Lane County, Oregon",613,378,235,613,128,485,613,50,54,59,28,10,10,47,52,14,40,85,43,23,48,31,19,41,039,000702,1,410390007021
"Block Group 3, Census Tract 9.02, Lane County, Oregon",561,395,166,561,81,480,561,7,27,20,7,28,46,67,6,7,19,114,128,36,7,9,33,41,039,000902,3,410390009023
"Block Group 1, Census Tract 9.02, Lane County, Oregon",326,221,105,326,63,263,326,17,0,36,0,52,9,8,6,0,26,0,81,41,18,21,11,41,039,000902,1,410390009021
"Block Group 1, Census Tract 9703, Malheur County, Oregon",313,274,39,313,99,214,313,9,0,0,22,0,35,57,25,11,49,40,9,18,0,9,29,41,045,970300,1,410459703001
"Block Group 3, Census Tract 9703, Malheur County, Oregon",258,165,93,258,68,190,258,51,10,8,25,0,26,0,11,17,17,32,16,17,28,0,0,41,045,970300,3,410459703003
"Block Group 5, Census Tract 9703, Malheur County, Oregon",426,275,151,426,159,267,426,85,27,27,21,0,60,29,20,63,22,53,0,19,0,0,0,41,045,970300,5,410459703005
"Block Group 4, Census Tract 9704, Malheur County, Oregon",242,139,103,242,93,149,242,59,15,40,0,31,0,7,0,8,21,26,6,17,12,0,0,41,045,970400,4,410459704004
"Block Group 5, Census Tract 9704, Malheur County, Oregon",272,226,46,272,65,207,272,43,41,16,32,0,0,0,0,40,40,30,24,0,0,6,0,41,045,970400,5,410459704005
"Block Group 2, Census Tract 46, Lane County, Oregon",518,436,82,518,84,434,518,43,26,37,38,37,15,10,25,11,27,63,55,46,33,28,24,41,039,004600,2,410390046002
"Block Group 3, Census Tract 46, Lane County, Oregon",242,136,106,242,24,218,242,0,14,0,0,12,16,9,19,19,25,18,17,44,39,10,0,41,039,004600,3,410390046003
"Block Group 1, Census Tract 51, Lane County, Oregon",704,547,157,704,181,523,704,57,63,64,95,56,45,62,8,11,73,62,33,31,28,0,16,41,039,005100,1,410390051001
"Block Group 2, Census Tract 51, Lane County, Oregon",801,623,178,801,121,680,801,63,31,24,78,31,85,26,10,40,45,81,96,37,94,17,43,41,039,005100,2,410390051002
"Block Group 1, Census Tract 9602, Wallowa County, Oregon",584,427,157,584,164,420,584,27,25,69,80,40,3,31,58,7,54,32,70,33,42,8,5,41,063,960200,1,410639602001
"Block Group 2, Census Tract 9602, Wallowa County, Oregon",244,179,65,244,19,225,244,9,15,1,9,13,5,26,22,12,38,22,28,21,10,13,0,41,063,960200,2,410639602002
"Block Group 1, Census Tract 9603, Wallowa County, Oregon",367,244,123,367,92,275,367,18,24,0,34,40,20,8,8,22,52,32,36,40,13,0,20,41,063,960300,1,410639603001
"Block Group 4, Census Tract 9603, Wallowa County, Oregon",300,136,164,300,7,293,300,52,34,27,15,5,15,0,13,4,21,7,25,47,18,13,4,41,063,960300,4,410639603004
"Block Group 3, Census Tract 9603, Wallowa County, Oregon",589,316,273,589,152,437,589,94,43,22,49,62,6,18,4,19,22,48,108,35,18,34,7,41,063,960300,3,410639603003
"Block Group 2, Census Tract 9603, Wallowa County, Oregon",212,176,36,212,23,189,212,0,0,5,8,20,8,17,13,4,21,12,47,20,21,16,0,41,063,960300,2,410639603002
"Block Group 2, Census Tract 327, Washington County, Oregon",963,839,124,963,92,871,963,0,20,28,30,21,38,52,27,17,59,93,148,152,82,117,79,41,067,032700,2,410670327002
"Block Group 3, Census Tract 327, Washington County, Oregon",689,554,135,689,104,585,689,17,21,35,14,17,19,55,45,10,18,46,83,34,68,71,136,41,067,032700,3,410670327003
"Block Group 2, Census Tract 318.04, Washington County, Oregon",1374,1250,124,1374,209,1165,1374,83,44,33,29,50,11,32,34,27,27,146,126,267,71,283,111,41,067,031804,2,410670318042
"Block Group 1, Census Tract 321.04, Washington County, Oregon",319,303,16,319,8,311,319,0,0,0,0,0,0,32,10,8,6,29,40,26,71,82,15,41,067,032104,1,410670321041
"Block Group 1, Census Tract 50, Multnomah County, Oregon",2508,2083,425,2508,131,2377,2508,196,87,11,26,83,31,9,40,74,59,203,256,369,390,367,307,41,051,005000,1,410510050001
"Block Group 1, Census Tract 61, Multnomah County, Oregon",523,389,134,523,9,514,523,16,0,12,19,0,8,0,0,15,10,27,15,42,46,102,211,41,051,006100,1,410510061001
"Block Group 1, Census Tract 62, Multnomah County, Oregon",469,381,88,469,15,454,469,0,13,0,9,0,10,0,16,10,13,31,101,24,58,49,135,41,051,006200,1,410510062001
"Block Group 1, Census Tract 66.01, Multnomah County, Oregon",669,439,230,669,9,660,669,6,7,19,37,22,14,26,40,54,18,43,28,99,93,64,99,41,051,006601,1,410510066011
"Block Group 2, Census Tract 104.05, Multnomah County, Oregon",328,249,79,328,23,305,328,0,0,18,0,52,0,19,42,29,0,10,44,93,21,0,0,41,051,010405,2,410510104052
"Block Group 3, Census Tract 104.05, Multnomah County, Oregon",685,593,92,685,182,503,685,0,0,67,112,151,23,15,48,30,48,32,106,12,0,41,0,41,051,010405,3,410510104053
"Block Group 2, Census Tract 9503.02, Curry County, Oregon",859,538,321,859,100,759,859,29,25,42,31,0,15,69,0,35,114,140,160,87,68,19,25,41,015,950302,2,410159503022
"Block Group 1, Census Tract 9503.02, Curry County, Oregon",507,269,238,507,151,356,507,14,36,37,101,53,0,0,0,58,0,56,108,10,0,34,0,41,015,950302,1,410159503021
"Block Group 2, Census Tract 9601, Gilliam County, Oregon",246,170,76,246,45,201,246,3,17,9,24,3,45,10,25,14,22,23,20,24,0,0,7,41,021,960100,2,410219601002
"Block Group 3, Census Tract 9601, Gilliam County, Oregon",242,115,127,242,25,217,242,24,36,10,5,0,17,21,2,23,3,29,27,27,14,4,0,41,021,960100,3,410219601003
"Block Group 3, Census Tract 9501, Hood River County, Oregon",251,201,50,251,22,229,251,0,0,38,0,23,0,35,33,12,20,19,9,22,20,20,0,41,027,950100,3,410279501003
"Block Group 1, Census Tract 9501, Hood River County, Oregon",546,378,168,546,105,441,546,40,39,29,26,30,13,6,21,36,112,36,44,88,8,6,12,41,027,950100,1,410279501001
"Block Group 3, Census Tract 9502, Hood River County, Oregon",485,328,157,485,23,462,485,13,24,0,0,16,15,10,13,26,44,23,100,23,34,81,63,41,027,950200,3,410279502003
"Block Group 5, Census Tract 9502, Hood River County, Oregon",511,422,89,511,22,489,511,0,0,23,0,23,12,43,0,0,31,22,144,88,0,51,74,41,027,950200,5,410279502005
"Block Group 3, Census Tract 9503, Hood River County, Oregon",370,295,75,370,64,306,370,0,33,18,0,82,0,46,26,0,37,47,24,0,20,37,0,41,027,950300,3,410279503003
"Block Group 1, Census Tract 9503, Hood River County, Oregon",285,241,44,285,21,264,285,21,0,0,0,34,25,41,0,0,15,21,0,0,54,46,28,41,027,950300,1,410279503001
"Block Group 2, Census Tract 9503, Hood River County, Oregon",615,456,159,615,68,547,615,0,0,21,0,60,17,36,104,48,0,0,104,142,60,3,20,41,027,950300,2,410279503002
"Block Group 5, Census Tract 9503, Hood River County, Oregon",338,305,33,338,13,325,338,0,17,0,34,14,0,0,74,0,20,66,36,32,0,37,8,41,027,950300,5,410279503005
"Block Group 1, Census Tract 9504, Hood River County, Oregon",488,439,49,488,27,461,488,0,0,30,7,28,0,21,43,47,53,55,73,31,37,14,49,41,027,950400,1,410279504001
"Block Group 2, Census Tract 9504, Hood River County, Oregon",511,379,132,511,19,492,511,0,9,8,56,43,5,0,10,0,57,55,72,86,51,18,41,41,027,950400,2,410279504002
"Block Group 3, Census Tract 10.01, Benton County, Oregon",605,510,95,605,75,530,605,64,24,61,78,49,31,0,0,39,59,55,76,40,0,10,19,41,003,001001,3,410030010013
"Block Group 1, Census Tract 10.01, Benton County, Oregon",559,407,152,559,118,441,559,34,10,49,29,39,63,22,17,6,67,53,46,85,24,7,8,41,003,001001,1,410030010011
"Block Group 3, Census Tract 11.02, Benton County, Oregon",407,340,67,407,46,361,407,52,12,62,0,13,22,0,36,32,23,55,32,21,0,47,0,41,003,001102,3,410030011023
"Block Group 4, Census Tract 11.02, Benton County, Oregon",426,311,115,426,66,360,426,146,72,15,54,14,55,32,0,10,16,0,12,0,0,0,0,41,003,001102,4,410030011024
"Block Group 1, Census Tract 1, Deschutes County, Oregon",813,568,245,813,15,798,813,20,16,17,18,31,34,16,25,33,28,45,95,91,79,151,114,41,017,000100,1,410170001001
"Block Group 2, Census Tract 2, Deschutes County, Oregon",484,129,355,484,113,371,484,121,58,32,43,0,3,16,73,0,13,66,7,24,6,22,0,41,017,000200,2,410170002002
"Block Group 1, Census Tract 2, Deschutes County, Oregon",800,345,455,800,103,697,800,85,140,0,0,18,99,33,48,0,72,81,31,60,80,36,17,41,017,000200,1,410170002001
"Block Group 3, Census Tract 3, Deschutes County, Oregon",474,320,154,474,135,339,474,10,9,0,64,27,13,15,13,17,45,56,94,104,0,0,7,41,017,000300,3,410170003003
"Block Group 1, Census Tract 3, Deschutes County, Oregon",1300,1023,277,1300,139,1161,1300,70,0,0,99,53,66,55,41,114,113,317,160,97,75,25,15,41,017,000300,1,410170003001
"Block Group 2, Census Tract 3, Deschutes County, Oregon",1057,615,442,1057,283,774,1057,96,24,76,26,79,47,48,78,0,69,112,183,153,35,10,21,41,017,000300,2,410170003002
"Block Group 3, Census Tract 5, Deschutes County, Oregon",428,330,98,428,15,413,428,4,40,3,5,0,11,15,0,13,12,72,105,16,48,27,57,41,017,000500,3,410170005003
"Block Group 1, Census Tract 5, Deschutes County, Oregon",669,515,154,669,44,625,669,16,42,88,14,61,0,14,5,0,15,103,24,133,32,98,24,41,017,000500,1,410170005001
"Block Group 3, Census Tract 6, Deschutes County, Oregon",525,394,131,525,16,509,525,0,0,0,16,30,0,69,16,42,26,64,98,67,22,33,42,41,017,000600,3,410170006003
"Block Group 1, Census Tract 7.05, Lane County, Oregon",337,178,159,337,85,252,337,43,74,8,17,14,35,8,16,0,6,49,27,23,9,0,8,41,039,000705,1,410390007051
"Block Group 2, Census Tract 7.05, Lane County, Oregon",952,268,684,952,150,802,952,99,127,89,70,66,59,64,61,63,24,56,71,23,36,20,24,41,039,000705,2,410390007052
"Block Group 1, Census Tract 25.03, Lane County, Oregon",1484,1230,254,1484,100,1384,1484,15,55,15,16,82,100,132,15,30,105,210,361,167,97,56,28,41,039,002503,1,410390025031
"Block Group 4, Census Tract 25.03, Lane County, Oregon",68,54,14,68,0,68,68,14,0,0,0,0,28,0,0,0,0,23,0,0,3,0,0,41,039,002503,4,410390025034
"Block Group 3, Census Tract 25.03, Lane County, Oregon",899,769,130,899,161,738,899,0,0,58,54,0,32,107,13,87,166,81,127,139,0,0,35,41,039,002503,3,410390025033
"Block Group 3, Census Tract 44.04, Lane County, Oregon",550,457,93,550,55,495,550,25,13,0,29,16,28,34,44,0,30,90,71,60,41,21,48,41,039,004404,3,410390044043
"Block Group 1, Census Tract 44.04, Lane County, Oregon",417,303,114,417,26,391,417,28,8,6,21,0,0,0,25,0,39,40,71,36,16,57,70,41,039,004404,1,410390044041
"Block Group 1, Census Tract 9602.02, Jefferson County, Oregon",457,261,196,457,146,311,457,62,13,28,18,13,71,0,0,0,74,12,93,0,41,0,32,41,031,960202,1,410319602021
"Block Group 3, Census Tract 310.04, Washington County, Oregon",546,493,53,546,0,546,546,16,0,0,0,20,11,0,0,17,48,61,70,150,51,46,56,41,067,031004,3,410670310043
"Block Group 2, Census Tract 310.04, Washington County, Oregon",581,484,97,581,36,545,581,15,0,0,0,12,0,36,29,27,20,32,63,101,78,96,72,41,067,031004,2,410670310042
"Block Group 1, Census Tract 310.04, Washington County, Oregon",768,697,71,768,120,648,768,0,45,47,31,0,13,0,0,111,50,80,102,89,72,41,87,41,067,031004,1,410670310041
"Block Group 1, Census Tract 311, Washington County, Oregon",897,748,149,897,175,722,897,38,22,109,27,68,82,16,77,22,108,78,109,56,29,46,10,41,067,031100,1,410670311001
"Block Group 2, Census Tract 311, Washington County, Oregon",365,299,66,365,117,248,365,41,8,51,16,9,28,16,13,13,11,35,86,38,0,0,0,41,067,031100,2,410670311002
"Block Group 1, Census Tract 314.03, Washington County, Oregon",305,288,17,305,64,241,305,0,25,13,0,13,0,16,9,61,20,15,36,34,36,27,0,41,067,031403,1,410670314031
"Block Group 2, Census Tract 314.03, Washington County, Oregon",931,809,122,931,102,829,931,7,36,46,0,32,64,48,44,56,139,157,95,50,75,39,43,41,067,031403,2,410670314032
"Block Group 3, Census Tract 314.03, Washington County, Oregon",676,539,137,676,78,598,676,27,52,7,0,0,33,9,0,62,89,88,93,30,78,53,55,41,067,031403,3,410670314033
"Block Group 1, Census Tract 315.07, Washington County, Oregon",1036,926,110,1036,19,1017,1036,32,19,19,0,19,27,19,0,20,68,26,82,133,69,152,351,41,067,031507,1,410670315071
"Block Group 2, Census Tract 315.07, Washington County, Oregon",388,280,108,388,0,388,388,15,7,22,17,0,20,0,0,0,0,0,129,107,11,15,45,41,067,031507,2,410670315072
"Block Group 3, Census Tract 315.07, Washington County, Oregon",828,710,118,828,99,729,828,35,55,26,0,18,70,63,123,49,112,61,69,35,70,27,15,41,067,031507,3,410670315073
"Block Group 3, Census Tract 4, Marion County, Oregon",411,326,85,411,168,243,411,128,0,19,19,19,23,72,0,21,25,10,75,0,0,0,0,41,047,000400,3,410470004003
"Block Group 5, Census Tract 16.02, Marion County, Oregon",718,704,14,718,283,435,718,0,20,66,132,33,95,42,0,99,19,101,111,0,0,0,0,41,047,001602,5,410470016025
"Block Group 4, Census Tract 31.02, Lane County, Oregon",1164,814,350,1164,227,937,1164,223,27,145,28,108,69,14,57,32,186,104,53,42,9,33,34,41,039,003102,4,410390031024
"Block Group 3, Census Tract 205.01, Clackamas County, Oregon",1082,937,145,1082,17,1065,1082,0,17,19,0,17,13,0,30,17,37,40,116,107,127,114,428,41,005,020501,3,410050205013
"Block Group 2, Census Tract 205.04, Clackamas County, Oregon",913,739,174,913,60,853,913,64,0,0,0,0,12,30,54,24,66,70,42,80,134,130,207,41,005,020504,2,410050205042
"Block Group 1, Census Tract 205.04, Clackamas County, Oregon",386,360,26,386,0,386,386,9,0,0,0,0,0,0,0,0,0,43,42,47,23,74,148,41,005,020504,1,410050205041
"Block Group 3, Census Tract 207, Clackamas County, Oregon",422,373,49,422,26,396,422,0,9,0,18,9,9,0,22,0,9,20,72,45,82,42,85,41,005,020700,3,410050207003
"Block Group 4, Census Tract 211, Clackamas County, Oregon",693,524,169,693,65,628,693,18,0,78,80,39,36,29,0,35,31,70,95,48,56,60,18,41,005,021100,4,410050211004
"Block Group 2, Census Tract 215, Clackamas County, Oregon",1256,680,576,1256,88,1168,1256,151,38,53,44,0,0,48,34,75,59,238,164,127,48,134,43,41,005,021500,2,410050215002
"Block Group 1, Census Tract 13, Deschutes County, Oregon",2442,1905,537,2442,315,2127,2442,252,44,24,97,75,79,251,93,22,44,211,385,205,113,124,423,41,017,001300,1,410170013001
"Block Group 2, Census Tract 13, Deschutes County, Oregon",1852,1460,392,1852,118,1734,1852,32,0,31,40,214,0,58,0,81,105,128,177,225,143,310,308,41,017,001300,2,410170013002
"Block Group 5, Census Tract 13, Deschutes County, Oregon",382,289,93,382,0,382,382,0,0,0,0,0,93,27,0,22,0,64,109,19,0,48,0,41,017,001300,5,410170013005
"Block Group 4, Census Tract 13, Deschutes County, Oregon",352,352,0,352,68,284,352,0,0,0,0,0,0,0,87,29,54,32,25,36,47,0,42,41,017,001300,4,410170013004
"Block Group 1, Census Tract 14, Deschutes County, Oregon",2236,1685,551,2236,75,2161,2236,124,13,59,41,52,101,60,165,20,129,236,305,221,103,165,442,41,017,001400,1,410170014001
"Block Group 3, Census Tract 14, Deschutes County, Oregon",260,235,25,260,19,241,260,15,0,0,16,0,0,0,0,0,31,36,54,0,19,66,23,41,017,001400,3,410170014003
"Block Group 3, Census Tract 15, Deschutes County, Oregon",885,749,136,885,349,536,885,115,0,0,81,29,48,113,49,118,7,48,68,24,88,97,0,41,017,001500,3,410170015003
"Block Group 5, Census Tract 15, Deschutes County, Oregon",794,722,72,794,95,699,794,17,17,45,29,145,0,0,0,0,165,102,49,136,38,51,0,41,017,001500,5,410170015005
"Block Group 1, Census Tract 15, Deschutes County, Oregon",227,214,13,227,44,183,227,13,0,0,0,15,42,0,49,0,26,16,66,0,0,0,0,41,017,001500,1,410170015001
"Block Group 3, Census Tract 17, Deschutes County, Oregon",454,288,166,454,17,437,454,0,0,0,15,102,0,0,76,62,15,71,19,37,21,36,0,41,017,001700,3,410170017003
"Block Group 1, Census Tract 17, Deschutes County, Oregon",1344,929,415,1344,117,1227,1344,96,0,60,84,51,37,84,34,41,108,191,219,121,65,125,28,41,017,001700,1,410170017001
"Block Group 1, Census Tract 9702, Union County, Oregon",413,304,109,413,96,317,413,20,20,64,4,0,14,32,4,30,54,31,95,8,0,37,0,41,061,970200,1,410619702001
"Block Group 3, Census Tract 9702, Union County, Oregon",390,307,83,390,75,315,390,8,35,32,22,22,37,33,19,11,64,30,24,20,15,10,8,41,061,970200,3,410619702003
"Block Group 2, Census Tract 9705, Union County, Oregon",466,402,64,466,77,389,466,0,0,37,15,71,11,44,19,36,57,47,62,54,0,0,13,41,061,970500,2,410619705002
"Block Group 1, Census Tract 9705, Union County, Oregon",399,285,114,399,142,257,399,70,19,26,15,12,34,11,0,8,18,48,127,0,11,0,0,41,061,970500,1,410619705001
"Block Group 1, Census Tract 9701, Union County, Oregon",322,229,93,322,22,300,322,9,0,24,14,25,0,22,18,9,43,57,42,27,21,11,0,41,061,970100,1,410619701001
"Block Group 4, Census Tract 9701, Union County, Oregon",286,228,58,286,41,245,286,9,0,15,11,10,8,19,7,12,6,38,65,48,13,17,8,41,061,970100,4,410619701004
"Block Group 2, Census Tract 9701, Union County, Oregon",534,312,222,534,126,408,534,31,53,31,15,63,45,10,65,33,30,39,61,42,2,3,11,41,061,970100,2,410619701002
"Block Group 2, Census Tract 305, Linn County, Oregon",794,629,165,794,141,653,794,57,11,35,31,52,37,38,41,32,75,79,86,81,57,39,43,41,043,030500,2,410430305002
"Block Group 1, Census Tract 305, Linn County, Oregon",368,242,126,368,63,305,368,45,10,11,10,3,7,9,38,0,24,27,21,51,33,79,0,41,043,030500,1,410430305001
"Block Group 3, Census Tract 207, Linn County, Oregon",770,641,129,770,178,592,770,41,12,0,72,58,48,49,44,107,41,33,96,89,50,0,30,41,043,020700,3,410430207003
"Block Group 1, Census Tract 207, Linn County, Oregon",893,729,164,893,159,734,893,15,68,46,13,0,122,67,38,50,14,156,121,86,45,52,0,41,043,020700,1,410430207001
"Block Group 2, Census Tract 207, Linn County, Oregon",494,381,113,494,105,389,494,21,24,19,49,0,35,14,46,25,25,55,125,42,0,0,14,41,043,020700,2,410430207002
"Block Group 3, Census Tract 800, Douglas County, Oregon",424,289,135,424,106,318,424,0,0,53,0,0,17,0,15,0,48,85,152,0,26,28,0,41,019,080000,3,410190800003
"Block Group 1, Census Tract 800, Douglas County, Oregon",1473,731,742,1473,197,1276,1473,45,70,159,51,53,96,78,105,20,101,60,211,20,97,103,204,41,019,080000,1,410190800001
"Block Group 1, Census Tract 1400, Douglas County, Oregon",401,169,232,401,0,401,401,30,0,0,62,11,0,12,36,12,34,37,39,78,21,11,18,41,019,140000,1,410191400001
"Block Group 2, Census Tract 1400, Douglas County, Oregon",544,414,130,544,54,490,544,0,0,43,26,17,42,32,66,0,96,30,59,58,13,25,37,41,019,140000,2,410191400002
"Block Group 5, Census Tract 1400, Douglas County, Oregon",436,290,146,436,143,293,436,42,0,81,0,67,13,31,22,0,97,40,34,9,0,0,0,41,019,140000,5,410191400005
"Block Group 4, Census Tract 1400, Douglas County, Oregon",471,294,177,471,78,393,471,0,92,22,43,12,18,46,71,20,0,0,60,58,29,0,0,41,019,140000,4,410191400004
"Block Group 3, Census Tract 1400, Douglas County, Oregon",724,486,238,724,85,639,724,56,81,102,42,101,59,14,27,67,21,30,102,7,15,0,0,41,019,140000,3,410191400003
"Block Group 5, Census Tract 1600, Douglas County, Oregon",528,209,319,528,195,333,528,16,43,0,83,0,32,56,16,112,111,31,15,0,0,13,0,41,019,160000,5,410191600005
"Block Group 1, Census Tract 1600, Douglas County, Oregon",633,170,463,633,115,518,633,0,117,107,31,0,54,31,0,0,15,109,28,15,13,73,40,41,019,160000,1,410191600001
"Block Group 3, Census Tract 1600, Douglas County, Oregon",726,499,227,726,175,551,726,0,0,29,26,98,52,60,60,41,15,145,115,43,27,15,0,41,019,160000,3,410191600003
"Block Group 4, Census Tract 1600, Douglas County, Oregon",332,270,62,332,134,198,332,0,87,15,16,0,16,0,101,49,0,0,0,48,0,0,0,41,019,160000,4,410191600004
"Block Group 3, Census Tract 1900, Douglas County, Oregon",379,174,205,379,61,318,379,10,21,48,42,28,0,20,0,30,73,60,15,4,0,20,8,41,019,190000,3,410191900003
"Block Group 1, Census Tract 1900, Douglas County, Oregon",989,538,451,989,294,695,989,77,113,135,56,67,40,31,50,47,67,56,90,56,40,56,8,41,019,190000,1,410191900001
"Block Group 4, Census Tract 200, Douglas County, Oregon",187,44,143,187,34,153,187,40,0,0,0,9,34,24,0,0,0,36,0,44,0,0,0,41,019,020000,4,410190200004
"Block Group 3, Census Tract 200, Douglas County, Oregon",636,388,248,636,145,491,636,132,39,39,33,21,38,0,18,16,16,148,23,104,0,9,0,41,019,020000,3,410190200003
"Block Group 1, Census Tract 1100, Douglas County, Oregon",418,249,169,418,29,389,418,8,34,27,0,0,12,64,0,33,54,98,32,31,9,8,8,41,019,110000,1,410191100001
"Block Group 3, Census Tract 1100, Douglas County, Oregon",265,195,70,265,43,222,265,3,8,34,7,16,9,8,18,9,9,12,40,32,33,22,5,41,019,110000,3,410191100003
"Block Group 1, Census Tract 2100, Douglas County, Oregon",232,133,99,232,51,181,232,16,13,11,14,31,4,22,16,0,27,19,39,17,3,0,0,41,019,210000,1,410192100001
"Block Group 5, Census Tract 302, Linn County, Oregon",476,345,131,476,72,404,476,9,22,38,22,26,20,17,15,8,37,78,97,36,15,21,15,41,043,030200,5,410430302005
"Block Group 6, Census Tract 302, Linn County, Oregon",509,308,201,509,120,389,509,0,0,0,56,65,18,0,19,33,29,44,88,35,58,42,22,41,043,030200,6,410430302006
"Block Group 2, Census Tract 302, Linn County, Oregon",344,240,104,344,124,220,344,70,55,22,18,19,3,8,0,2,25,39,50,14,3,0,16,41,043,030200,2,410430302002
"Block Group 3, Census Tract 303, Linn County, Oregon",253,216,37,253,19,234,253,6,0,7,5,10,4,3,39,15,15,43,26,34,5,37,4,41,043,030300,3,410430303003
"Block Group 1, Census Tract 303, Linn County, Oregon",308,197,111,308,68,240,308,21,33,3,15,29,16,10,4,7,33,40,45,33,0,15,4,41,043,030300,1,410430303001
"Block Group 5, Census Tract 304.01, Linn County, Oregon",203,145,58,203,75,128,203,48,0,0,0,34,16,0,0,0,27,78,0,0,0,0,0,41,043,030401,5,410430304015
"Block Group 2, Census Tract 304.01, Linn County, Oregon",731,468,263,731,92,639,731,16,74,46,27,36,0,58,11,40,37,28,62,198,23,62,13,41,043,030401,2,410430304012
"Block Group 4, Census Tract 9, Marion County, Oregon",369,269,100,369,112,257,369,15,35,13,0,85,16,10,0,94,0,0,54,46,1,0,0,41,047,000900,4,410470009004
"Block Group 1, Census Tract 9, Marion County, Oregon",483,325,158,483,196,287,483,77,65,11,0,0,47,109,0,0,0,22,16,39,18,64,15,41,047,000900,1,410470009001
"Block Group 2, Census Tract 9, Marion County, Oregon",329,315,14,329,98,231,329,0,15,0,10,0,71,0,0,19,131,36,16,31,0,0,0,41,047,000900,2,410470009002
"Block Group 6, Census Tract 9, Marion County, Oregon",265,160,105,265,81,184,265,28,15,50,16,0,9,7,0,37,0,40,25,0,38,0,0,41,047,000900,6,410470009006
"Block Group 7, Census Tract 9, Marion County, Oregon",325,277,48,325,59,266,325,96,0,0,49,0,0,15,0,8,16,14,115,12,0,0,0,41,047,000900,7,410470009007
"Block Group 5, Census Tract 9, Marion County, Oregon",183,169,14,183,76,107,183,0,12,13,28,0,15,1,14,0,17,19,31,32,0,0,1,41,047,000900,5,410470009005
"Block Group 1, Census Tract 15.02, Marion County, Oregon",859,709,150,859,148,711,859,0,58,23,72,37,85,36,53,52,65,116,105,102,24,23,8,41,047,001502,1,410470015021
"Block Group 2, Census Tract 15.02, Marion County, Oregon",689,632,57,689,206,483,689,10,41,23,52,9,9,38,44,19,68,92,156,88,7,11,22,41,047,001502,2,410470015022
"Block Group 3, Census Tract 15.02, Marion County, Oregon",380,281,99,380,53,327,380,8,20,19,0,0,20,19,11,0,34,47,88,79,17,18,0,41,047,001502,3,410470015023
"Block Group 2, Census Tract 9601, Grant County, Oregon",173,109,64,173,50,123,173,14,11,9,12,15,4,0,0,8,34,31,35,0,0,0,0,41,023,960100,2,410239601002
"Block Group 1, Census Tract 9601, Grant County, Oregon",387,240,147,387,41,346,387,36,22,34,12,28,18,24,18,22,24,72,20,21,4,15,17,41,023,960100,1,410239601001
"Block Group 3, Census Tract 9601, Grant County, Oregon",349,210,139,349,21,328,349,13,42,13,11,24,20,8,13,29,48,35,23,48,11,0,11,41,023,960100,3,410239601003
"Block Group 2, Census Tract 9601, Jefferson County, Oregon",397,316,81,397,91,306,397,26,0,41,5,42,26,20,9,0,4,40,105,23,34,12,10,41,031,960100,2,410319601002
"Block Group 1, Census Tract 9601, Jefferson County, Oregon",213,141,72,213,29,184,213,18,0,5,1,1,5,24,0,27,7,16,51,23,8,24,3,41,031,960100,1,410319601001
"Block Group 3, Census Tract 52.02, Polk County, Oregon",1186,925,261,1186,144,1042,1186,90,15,0,31,32,13,31,0,43,74,113,74,230,91,219,130,41,053,005202,3,410530052023
"Block Group 2, Census Tract 52.02, Polk County, Oregon",1005,768,237,1005,270,735,1005,103,63,56,65,0,44,127,107,34,171,96,82,29,14,0,14,41,053,005202,2,410530052022
"Block Group 2, Census Tract 53, Polk County, Oregon",619,216,403,619,31,588,619,16,0,37,0,18,30,49,12,42,82,68,147,36,56,13,13,41,053,005300,2,410530053002
"Block Group 4, Census Tract 53, Polk County, Oregon",593,492,101,593,37,556,593,15,0,0,18,0,0,21,0,34,77,34,44,93,30,190,37,41,053,005300,4,410530053004
"Block Group 3, Census Tract 53, Polk County, Oregon",1071,877,194,1071,41,1030,1071,59,0,39,17,20,237,0,0,17,20,130,120,135,70,158,49,41,053,005300,3,410530053003
"Block Group 2, Census Tract 314.04, Washington County, Oregon",298,258,40,298,0,298,298,11,0,10,6,0,17,0,0,0,28,38,14,37,80,40,17,41,067,031404,2,410670314042
"Block Group 1, Census Tract 9504, Curry County, Oregon",651,318,333,651,193,458,651,33,67,104,53,37,116,0,0,9,48,24,0,61,62,37,0,41,015,950400,1,410159504001
"Block Group 1, Census Tract 204, Linn County, Oregon",289,204,85,289,70,219,289,17,9,0,43,0,24,18,13,9,28,35,58,17,18,0,0,41,043,020400,1,410430204001
"Block Group 1, Census Tract 16.02, Jackson County, Oregon",517,301,216,517,110,407,517,0,17,112,0,0,63,28,15,38,53,98,37,14,30,12,0,41,029,001602,1,410290016021
"Block Group 4, Census Tract 326.03, Washington County, Oregon",1007,800,207,1007,81,926,1007,11,0,31,36,20,0,12,38,0,106,116,76,79,144,219,119,41,067,032603,4,410670326034
"Block Group 1, Census Tract 226.03, Clackamas County, Oregon",1512,1286,226,1512,214,1298,1512,93,18,0,31,50,38,52,143,56,193,91,353,94,199,86,15,41,005,022603,1,410050226031
"Block Group 1, Census Tract 1500, Douglas County, Oregon",963,647,316,963,209,754,963,26,18,126,19,61,74,118,36,67,80,127,80,58,29,0,44,41,019,150000,1,410191500001
"Block Group 1, Census Tract 35.02, Multnomah County, Oregon",590,550,40,590,57,533,590,23,16,0,0,17,24,14,41,55,31,79,25,68,93,76,28,41,051,003502,1,410510035021
"Block Group 3, Census Tract 235, Clackamas County, Oregon",359,249,110,359,93,266,359,19,41,35,0,0,17,36,0,18,17,59,24,0,75,0,18,41,005,023500,3,410050235003
"Block Group 1, Census Tract 6.02, Jackson County, Oregon",911,571,340,911,347,564,911,72,110,80,74,84,42,93,0,0,33,72,98,79,17,12,45,41,029,000602,1,410290006021
"Block Group 5, Census Tract 18.02, Marion County, Oregon",569,443,126,569,189,380,569,50,0,82,0,31,0,16,36,49,56,32,156,40,21,0,0,41,047,001802,5,410470018025
"Block Group 2, Census Tract 243.02, Clackamas County, Oregon",646,473,173,646,16,630,646,0,0,51,18,0,16,0,0,36,32,115,158,40,58,110,12,41,005,024302,2,410050243022
"Block Group 1, Census Tract 205, Polk County, Oregon",529,356,173,529,30,499,529,71,5,5,13,12,9,0,27,13,33,24,78,45,83,69,42,41,053,020500,1,410530205001
"Block Group 2, Census Tract 306.02, Yamhill County, Oregon",1135,733,402,1135,59,1076,1135,35,0,24,18,22,24,36,32,27,131,174,150,81,45,87,249,41,071,030602,2,410710306022
"Block Group 4, Census Tract 3616, Josephine County, Oregon",543,274,269,543,86,457,543,44,65,0,15,38,122,28,0,0,30,60,117,18,0,6,0,41,033,361600,4,410333616004
"Block Group 2, Census Tract 11, Marion County, Oregon",915,675,240,915,146,769,915,17,44,29,20,41,14,30,40,59,96,158,155,40,113,28,31,41,047,001100,2,410470011002
"Block Group 2, Census Tract 9505, Clatsop County, Oregon",310,226,84,310,38,272,310,9,23,30,8,30,8,9,10,0,42,36,20,26,59,0,0,41,007,950500,2,410079505002
"Block Group 2, Census Tract 28.01, Multnomah County, Oregon",606,495,111,606,42,564,606,39,18,6,31,0,8,16,23,16,26,84,102,47,24,130,36,41,051,002801,2,410510028012
"Block Group 3, Census Tract 12.01, Multnomah County, Oregon",454,347,107,454,111,343,454,20,47,14,20,25,0,35,0,0,50,73,82,31,57,0,0,41,051,001201,3,410510012013
"Block Group 1, Census Tract 9800, Clackamas County, Oregon",11,11,0,11,0,11,11,0,0,0,0,0,0,0,0,0,0,0,7,4,0,0,0,41,005,980000,1,410059800001
"Block Group 2, Census Tract 109, Benton County, Oregon",1219,980,239,1219,56,1163,1219,79,40,0,35,0,25,119,10,58,98,144,105,155,93,163,95,41,003,010900,2,410030109002
"Block Group 2, Census Tract 44.05, Lane County, Oregon",542,434,108,542,13,529,542,20,0,9,56,13,9,15,17,0,36,50,75,70,53,59,60,41,039,004405,2,410390044052
"Block Group 2, Census Tract 226.02, Clackamas County, Oregon",818,593,225,818,70,748,818,0,8,27,0,46,16,7,32,15,74,61,153,171,53,71,84,41,005,022602,2,410050226022
"Block Group 1, Census Tract 3603, Josephine County, Oregon",585,366,219,585,55,530,585,47,16,44,15,17,19,0,0,32,78,67,204,46,0,0,0,41,033,360300,1,410333603001
"Block Group 2, Census Tract 27, Marion County, Oregon",447,357,90,447,27,420,447,4,13,21,4,4,19,21,7,8,13,118,84,33,35,41,22,41,047,002700,2,410470027002
"Block Group 1, Census Tract 9510, Lincoln County, Oregon",349,199,150,349,73,276,349,20,45,15,69,15,0,12,13,7,10,12,76,43,4,0,8,41,041,951000,1,410419510001
"Block Group 3, Census Tract 201, Clackamas County, Oregon",405,301,104,405,79,326,405,12,0,9,18,38,0,0,15,17,14,78,23,47,14,58,62,41,005,020100,3,410050201003
"Block Group 4, Census Tract 9505, Umatilla County, Oregon",346,261,85,346,6,340,346,0,0,0,6,7,8,20,25,0,25,34,109,24,36,37,15,41,059,950500,4,410599505004
"Block Group 3, Census Tract 315.14, Washington County, Oregon",1299,813,486,1299,165,1134,1299,35,89,38,34,0,59,49,75,34,64,87,103,122,211,168,131,41,067,031514,3,410670315143
"Block Group 2, Census Tract 318.14, Washington County, Oregon",1022,905,117,1022,22,1000,1022,18,34,0,35,0,38,22,0,0,53,47,86,108,130,182,269,41,067,031814,2,410670318142
"Block Group 2, Census Tract 9511, Clatsop County, Oregon",316,264,52,316,68,248,316,14,0,10,27,19,14,10,0,6,51,23,47,59,9,27,0,41,007,951100,2,410079511002
"Block Group 1, Census Tract 109, Benton County, Oregon",977,782,195,977,62,915,977,36,19,10,30,10,10,56,29,41,38,92,201,132,91,83,99,41,003,010900,1,410030109001
"Block Group 3, Census Tract 217, Clackamas County, Oregon",1028,764,264,1028,184,844,1028,60,27,132,111,179,11,13,146,20,47,71,130,49,0,17,15,41,005,021700,3,410050217003
"Block Group 4, Census Tract 7, Deschutes County, Oregon",567,440,127,567,124,443,567,39,0,25,34,60,67,36,0,51,59,39,13,59,52,33,0,41,017,000700,4,410170007004
"Block Group 4, Census Tract 9716, Klamath County, Oregon",411,300,111,411,79,332,411,0,40,92,8,74,10,37,15,25,56,35,0,19,0,0,0,41,035,971600,4,410359716004
"Block Group 5, Census Tract 9719, Klamath County, Oregon",127,92,35,127,68,59,127,22,12,10,18,8,11,0,0,0,18,0,9,19,0,0,0,41,035,971900,5,410359719005
"Block Group 2, Census Tract 37.01, Multnomah County, Oregon",562,432,130,562,130,432,562,81,68,51,0,27,37,9,0,12,37,86,30,55,8,43,18,41,051,003701,2,410510037012
"Block Group 2, Census Tract 38.03, Multnomah County, Oregon",764,700,64,764,132,632,764,90,0,45,0,9,45,29,41,39,71,81,129,90,17,68,10,41,051,003803,2,410510038032
"Block Group 4, Census Tract 9, Deschutes County, Oregon",760,556,204,760,248,512,760,13,61,68,41,125,26,16,40,49,0,103,164,37,0,17,0,41,017,000900,4,410170009004
"Block Group 4, Census Tract 5, Deschutes County, Oregon",845,584,261,845,103,742,845,52,18,55,54,25,41,62,49,38,41,120,105,55,36,67,27,41,017,000500,4,410170005004
"Block Group 3, Census Tract 9607, Tillamook County, Oregon",266,165,101,266,32,234,266,0,0,61,35,9,0,0,8,10,16,18,72,16,21,0,0,41,057,960700,3,410579607003
"Block Group 1, Census Tract 202.02, Polk County, Oregon",938,602,336,938,67,871,938,0,27,13,60,38,41,12,88,75,44,59,175,182,43,0,81,41,053,020202,1,410530202021
"Block Group 2, Census Tract 9501, Crook County, Oregon",638,444,194,638,12,626,638,86,21,17,45,80,0,22,0,86,13,39,71,45,45,68,0,41,013,950100,2,410139501002
"Block Group 1, Census Tract 9702, Wasco County, Oregon",303,255,48,303,44,259,303,0,6,15,10,38,0,32,23,12,58,55,40,0,0,0,14,41,065,970200,1,410659702001
"Block Group 1, Census Tract 8, Coos County, Oregon",484,306,178,484,46,438,484,29,8,0,26,35,24,0,17,10,58,68,73,23,41,30,42,41,011,000800,1,410110008001
"Block Group 2, Census Tract 9601, Harney County, Oregon",392,271,121,392,72,320,392,9,4,51,43,46,36,36,3,0,94,14,4,0,33,19,0,41,025,960100,2,410259601002
"Block Group 1, Census Tract 99.06, Multnomah County, Oregon",862,653,209,862,85,777,862,13,6,10,0,48,46,48,6,52,77,75,137,134,62,77,71,41,051,009906,1,410510099061
"Block Group 1, Census Tract 305.02, Yamhill County, Oregon",519,335,184,519,93,426,519,37,48,17,90,33,27,9,46,22,30,35,65,10,11,31,8,41,071,030502,1,410710305021
"Block Group 3, Census Tract 16.03, Marion County, Oregon",378,323,55,378,39,339,378,0,19,0,0,0,18,32,18,17,77,31,44,56,0,50,16,41,047,001603,3,410470016033
"Block Group 4, Census Tract 59, Multnomah County, Oregon",912,837,75,912,101,811,912,20,0,67,45,35,38,70,45,18,108,18,210,62,33,69,74,41,051,005900,4,410510059004
"Block Group 1, Census Tract 19.03, Lane County, Oregon",759,652,107,759,271,488,759,50,33,23,32,35,48,42,11,16,81,100,166,62,8,41,11,41,039,001903,1,410390019031
"Block Group 3, Census Tract 10, Coos County, Oregon",483,204,279,483,100,383,483,91,67,36,66,29,32,28,3,3,19,95,0,0,1,13,0,41,011,001000,3,410110010003
"Block Group 1, Census Tract 239.02, Clackamas County, Oregon",952,696,256,952,215,737,952,33,43,131,55,41,31,28,0,52,68,115,120,88,43,82,22,41,005,023902,1,410050239021
"Block Group 2, Census Tract 329.01, Washington County, Oregon",822,667,155,822,174,648,822,41,27,18,19,35,113,9,57,126,86,40,161,17,31,31,11,41,067,032901,2,410670329012
"Block Group 2, Census Tract 310.05, Washington County, Oregon",667,542,125,667,68,599,667,16,0,0,118,32,0,0,45,13,89,98,103,48,89,16,0,41,067,031005,2,410670310052
"Block Group 1, Census Tract 32.02, Lane County, Oregon",539,454,85,539,130,409,539,8,26,0,27,53,18,29,29,44,26,65,135,29,12,13,25,41,039,003202,1,410390032021
"Block Group 2, Census Tract 54, Lane County, Oregon",529,411,118,529,25,504,529,16,11,0,29,0,17,15,0,48,0,40,132,62,89,41,29,41,039,005400,2,410390054002
"Block Group 2, Census Tract 24.03, Lane County, Oregon",463,388,75,463,35,428,463,9,8,0,24,9,33,35,35,0,12,45,94,63,71,25,0,41,039,002403,2,410390024032
"Block Group 2, Census Tract 98.01, Multnomah County, Oregon",763,626,137,763,299,464,763,92,95,57,114,8,62,36,0,11,75,48,74,22,30,31,8,41,051,009801,2,410510098012
"Block Group 3, Census Tract 25.01, Marion County, Oregon",1464,1162,302,1464,187,1277,1464,18,69,37,95,61,46,129,33,14,166,134,125,183,57,111,186,41,047,002501,3,410470025013
"Block Group 3, Census Tract 500.02, Douglas County, Oregon",778,576,202,778,302,476,778,134,32,0,75,0,128,33,55,6,123,67,51,65,9,0,0,41,019,050002,3,410190500023
"Block Group 4, Census Tract 309.02, Linn County, Oregon",351,269,82,351,15,336,351,16,18,0,0,35,17,15,0,16,0,32,34,34,0,68,66,41,043,030902,4,410430309024
"Block Group 2, Census Tract 304.02, Linn County, Oregon",1022,702,320,1022,401,621,1022,44,64,16,44,31,95,19,116,14,213,148,127,46,27,0,18,41,043,030402,2,410430304022
"Block Group 3, Census Tract 9501, Curry County, Oregon",435,205,230,435,133,302,435,48,122,27,26,56,20,5,16,12,27,33,16,7,9,0,11,41,015,950100,3,410159501003
"Block Group 2, Census Tract 35, Lane County, Oregon",520,408,112,520,82,438,520,9,11,7,51,7,26,6,62,77,14,93,122,16,19,0,0,41,039,003500,2,410390035002
"Block Group 2, Census Tract 9704, Wasco County, Oregon",771,493,278,771,124,647,771,20,96,75,42,69,38,16,47,25,16,56,79,40,34,42,76,41,065,970400,2,410659704002
"Block Group 3, Census Tract 2000, Douglas County, Oregon",566,246,320,566,115,451,566,42,50,27,53,71,15,38,65,53,29,23,72,21,3,4,0,41,019,200000,3,410192000003
"Block Group 1, Census Tract 46, Lane County, Oregon",502,378,124,502,107,395,502,90,24,47,8,11,0,10,23,8,13,115,41,47,39,26,0,41,039,004600,1,410390046001
"Block Group 2, Census Tract 1500, Douglas County, Oregon",1217,1074,143,1217,300,917,1217,51,36,35,15,40,71,117,67,68,246,104,154,129,52,20,12,41,019,150000,2,410191500002
"Block Group 3, Census Tract 27, Marion County, Oregon",543,466,77,543,77,466,543,0,0,0,0,0,72,0,18,20,13,48,173,76,39,55,29,41,047,002700,3,410470027003
"Block Group 3, Census Tract 202.02, Polk County, Oregon",920,580,340,920,523,397,920,148,105,83,15,67,37,70,83,38,135,54,63,22,0,0,0,41,053,020202,3,410530202023
"Block Group 1, Census Tract 16.04, Marion County, Oregon",911,736,175,911,489,422,911,76,133,37,18,26,112,0,31,77,189,69,63,66,0,14,0,41,047,001604,1,410470016041
"Block Group 4, Census Tract 30.01, Jackson County, Oregon",303,207,96,303,7,296,303,65,8,11,15,11,22,0,0,0,36,48,10,11,31,35,0,41,029,003001,4,410290030014
"Block Group 2, Census Tract 9501, Umatilla County, Oregon",252,172,80,252,0,252,252,10,0,41,0,20,0,0,8,0,24,33,39,46,6,0,25,41,059,950100,2,410599501002
"Block Group 2, Census Tract 92.01, Multnomah County, Oregon",1136,1000,136,1136,329,807,1136,64,29,113,52,46,96,15,25,21,46,192,139,180,81,37,0,41,051,009201,2,410510092012
"Block Group 3, Census Tract 31, Multnomah County, Oregon",398,335,63,398,15,383,398,8,0,8,16,0,0,18,11,23,24,22,32,25,41,117,53,41,051,003100,3,410510031003
"Block Group 2, Census Tract 305.02, Washington County, Oregon",373,348,25,373,49,324,373,11,31,37,9,28,0,0,40,9,0,0,55,34,49,34,36,41,067,030502,2,410670305022
"Block Group 4, Census Tract 315.04, Washington County, Oregon",1006,847,159,1006,82,924,1006,50,0,34,0,30,35,90,48,0,32,74,230,98,89,53,143,41,067,031504,4,410670315044
"Block Group 1, Census Tract 19.02, Lane County, Oregon",762,414,348,762,378,384,762,236,29,65,52,26,46,60,0,0,77,34,74,54,9,0,0,41,039,001902,1,410390019021
"Block Group 1, Census Tract 9704, Malheur County, Oregon",515,411,104,515,327,188,515,42,68,27,17,23,8,54,27,40,18,94,87,10,0,0,0,41,045,970400,1,410459704001
"Block Group 5, Census Tract 9702, Morrow County, Oregon",170,105,65,170,30,140,170,0,9,3,0,3,44,6,14,4,38,2,19,8,9,3,8,41,049,970200,5,410499702005
"Block Group 1, Census Tract 3.01, Multnomah County, Oregon",613,471,142,613,181,432,613,63,13,35,0,44,17,0,18,123,18,68,40,34,58,59,23,41,051,000301,1,410510003011
"Block Group 3, Census Tract 81, Multnomah County, Oregon",482,366,116,482,105,377,482,104,37,32,11,0,68,14,79,0,90,0,33,14,0,0,0,41,051,008100,3,410510081003
"Block Group 3, Census Tract 8.01, Multnomah County, Oregon",526,490,36,526,109,417,526,50,0,16,17,66,0,0,24,10,17,92,24,9,18,109,74,41,051,000801,3,410510008013
"Block Group 1, Census Tract 83.02, Multnomah County, Oregon",749,612,137,749,202,547,749,62,13,34,0,99,68,60,8,18,38,65,80,41,33,108,22,41,051,008302,1,410510083021
"Block Group 6, Census Tract 317.04, Washington County, Oregon",1045,914,131,1045,43,1002,1045,27,0,0,15,38,35,0,18,36,126,65,304,174,122,85,0,41,067,031704,6,410670317046
"Block Group 2, Census Tract 9603, Tillamook County, Oregon",771,578,193,771,119,652,771,43,25,77,41,19,29,24,25,63,41,114,93,113,41,19,4,41,057,960300,2,410579603002
"Block Group 1, Census Tract 27.02, Multnomah County, Oregon",696,548,148,696,85,611,696,48,0,17,21,54,63,34,67,32,10,113,48,25,26,73,65,41,051,002702,1,410510027021
"Block Group 4, Census Tract 12, Deschutes County, Oregon",1313,1109,204,1313,112,1201,1313,29,48,14,54,22,24,32,113,34,99,67,208,104,149,177,139,41,017,001200,4,410170012004
"Block Group 1, Census Tract 301, Linn County, Oregon",453,378,75,453,70,383,453,29,8,16,13,9,3,72,25,30,31,53,53,49,51,11,0,41,043,030100,1,410430301001
"Block Group 4, Census Tract 237, Clackamas County, Oregon",490,382,108,490,18,472,490,11,9,28,0,0,30,28,17,9,17,54,114,44,56,49,24,41,005,023700,4,410050237004
"Block Group 2, Census Tract 205.03, Clackamas County, Oregon",418,315,103,418,14,404,418,0,5,0,5,23,24,23,0,5,32,10,45,46,67,5,128,41,005,020503,2,410050205032
"Block Group 2, Census Tract 13.01, Jackson County, Oregon",70,46,24,70,17,53,70,8,0,17,0,0,0,0,7,0,0,17,11,10,0,0,0,41,029,001301,2,410290013012
"Block Group 2, Census Tract 26, Jackson County, Oregon",541,326,215,541,80,461,541,21,23,56,26,25,34,28,42,31,20,28,71,56,35,0,45,41,029,002600,2,410290026002
"Block Group 1, Census Tract 9714, Klamath County, Oregon",323,250,73,323,75,248,323,61,27,12,13,0,0,30,13,14,54,21,65,13,0,0,0,41,035,971400,1,410359714001
"Block Group 1, Census Tract 219, Clackamas County, Oregon",986,769,217,986,276,710,986,92,42,29,76,41,71,41,23,11,72,171,103,118,6,26,64,41,005,021900,1,410050219001
"Block Group 2, Census Tract 9502, Baker County, Oregon",450,380,70,450,121,329,450,35,38,53,22,12,2,20,30,29,58,36,45,40,7,4,19,41,001,950200,2,410019502002
"Block Group 3, Census Tract 13.01, Lane County, Oregon",338,247,91,338,46,292,338,0,10,28,19,0,42,12,0,18,18,49,88,10,38,0,6,41,039,001301,3,410390013013
"Block Group 3, Census Tract 14.01, Marion County, Oregon",729,637,92,729,191,538,729,57,13,31,0,83,50,49,0,43,90,78,175,40,0,0,20,41,047,001401,3,410470014013
"Block Group 1, Census Tract 41.02, Multnomah County, Oregon",564,522,42,564,81,483,564,83,20,0,0,0,16,36,0,0,113,80,116,82,0,18,0,41,051,004102,1,410510041021
"Block Group 2, Census Tract 85, Multnomah County, Oregon",492,423,69,492,141,351,492,0,0,0,14,65,46,18,33,16,17,34,128,40,18,38,25,41,051,008500,2,410510085002
"Block Group 3, Census Tract 62, Multnomah County, Oregon",452,402,50,452,23,429,452,8,15,0,9,0,21,6,0,10,29,15,120,90,44,24,61,41,051,006200,3,410510062003
"Block Group 1, Census Tract 9502, Hood River County, Oregon",628,432,196,628,45,583,628,12,39,0,17,48,12,34,12,49,0,124,79,14,87,14,87,41,027,950200,1,410279502001
"Block Group 1, Census Tract 12, Deschutes County, Oregon",528,455,73,528,42,486,528,0,16,8,0,45,41,0,0,46,68,62,106,65,36,6,29,41,017,001200,1,410170012001
"Block Group 4, Census Tract 17, Deschutes County, Oregon",743,651,92,743,183,560,743,42,21,18,30,11,54,0,21,55,40,86,199,46,53,67,0,41,017,001700,4,410170017004
"Block Group 4, Census Tract 1, Benton County, Oregon",1304,1132,172,1304,151,1153,1304,15,44,42,50,40,75,87,0,42,107,116,250,212,45,127,52,41,003,000100,4,410030001004
"Block Group 4, Census Tract 9.03, Lane County, Oregon",540,426,114,540,149,391,540,0,16,0,18,18,0,13,17,28,46,26,235,21,51,29,22,41,039,000903,4,410390009034
"Block Group 1, Census Tract 308.01, Washington County, Oregon",895,740,155,895,28,867,895,13,9,0,48,37,33,88,13,64,124,0,134,61,83,149,39,41,067,030801,1,410670308011
"Block Group 1, Census Tract 3, Lane County, Oregon",481,300,181,481,79,402,481,29,0,9,87,0,9,37,18,7,34,14,48,47,16,36,90,41,039,000300,1,410390003001
"Block Group 1, Census Tract 30, Lane County, Oregon",403,351,52,403,46,357,403,0,16,30,0,0,0,16,13,56,42,108,44,0,0,45,33,41,039,003000,1,410390030001
"Block Group 3, Census Tract 18.01, Multnomah County, Oregon",852,714,138,852,245,607,852,89,0,18,11,52,48,59,20,22,16,122,114,118,52,49,62,41,051,001801,3,410510018013
"Block Group 2, Census Tract 329.02, Washington County, Oregon",844,570,274,844,16,828,844,0,32,12,36,38,19,123,119,0,48,68,179,0,110,14,46,41,067,032902,2,410670329022
"Block Group 2, Census Tract 6.01, Multnomah County, Oregon",389,333,56,389,110,279,389,29,29,0,39,18,16,0,6,26,102,41,36,20,0,10,17,41,051,000601,2,410510006012
"Block Group 1, Census Tract 5.04, Coos County, Oregon",374,180,194,374,197,177,374,46,115,30,0,15,31,54,0,35,33,0,15,0,0,0,0,41,011,000504,1,410110005041
"Block Group 1, Census Tract 227.10, Clackamas County, Oregon",1202,1079,123,1202,94,1108,1202,43,51,16,10,39,100,42,31,54,70,163,158,151,120,99,55,41,005,022710,1,410050227101
"Block Group 1, Census Tract 318.15, Washington County, Oregon",998,855,143,998,39,959,998,0,0,0,22,0,0,48,0,30,63,125,91,110,50,360,99,41,067,031815,1,410670318151
"Block Group 4, Census Tract 13.02, Jackson County, Oregon",831,647,184,831,270,561,831,76,0,245,59,28,71,36,34,21,52,77,132,0,0,0,0,41,029,001302,4,410290013024
"Block Group 2, Census Tract 13.02, Jackson County, Oregon",912,733,179,912,45,867,912,36,0,0,0,0,17,18,31,15,18,176,67,143,201,66,124,41,029,001302,2,410290013022
"Block Group 1, Census Tract 22, Jackson County, Oregon",449,297,152,449,17,432,449,17,28,0,0,28,43,0,46,0,14,34,61,89,28,0,61,41,029,002200,1,410290022001
"Block Group 2, Census Tract 30.01, Jackson County, Oregon",490,296,194,490,34,456,490,44,0,45,24,11,11,32,53,18,5,46,65,59,25,52,0,41,029,003001,2,410290030012
"Block Group 3, Census Tract 30.01, Jackson County, Oregon",463,254,209,463,94,369,463,30,42,51,65,4,0,11,40,32,67,23,33,33,32,0,0,41,029,003001,3,410290030013
"Block Group 2, Census Tract 6.01, Jackson County, Oregon",564,389,175,564,15,549,564,0,15,15,13,8,42,0,0,0,52,33,77,146,62,14,87,41,029,000601,2,410290006012
"Block Group 1, Census Tract 240, Clackamas County, Oregon",698,527,171,698,92,606,698,18,39,0,7,0,15,26,59,23,79,98,111,37,35,42,109,41,005,024000,1,410050240001
"Block Group 1, Census Tract 218.02, Clackamas County, Oregon",953,694,259,953,160,793,953,11,65,71,69,57,40,43,58,33,109,142,138,30,70,10,7,41,005,021802,1,410050218021
"Block Group 3, Census Tract 9513, Umatilla County, Oregon",376,314,62,376,54,322,376,6,17,41,37,4,43,5,16,18,53,33,24,19,32,17,11,41,059,951300,3,410599513003
"Block Group 3, Census Tract 9501, Umatilla County, Oregon",303,265,38,303,20,283,303,5,9,19,8,9,22,3,4,0,53,9,36,67,11,0,48,41,059,950100,3,410599501003
"Block Group 4, Census Tract 9501, Umatilla County, Oregon",387,291,96,387,55,332,387,13,7,9,19,41,7,20,36,6,43,22,63,47,23,27,4,41,059,950100,4,410599501004
"Block Group 1, Census Tract 9511, Umatilla County, Oregon",237,217,20,237,9,228,237,0,0,0,58,19,0,0,0,13,9,16,21,20,0,34,47,41,059,951100,1,410599511001
"Block Group 2, Census Tract 9511, Umatilla County, Oregon",714,618,96,714,110,604,714,0,0,14,107,33,65,71,45,76,84,89,34,0,33,23,40,41,059,951100,2,410599511002
"Block Group 4, Census Tract 9512, Umatilla County, Oregon",284,224,60,284,32,252,284,0,0,0,0,67,0,12,46,0,45,14,28,48,9,15,0,41,059,951200,4,410599512004
"Block Group 1, Census Tract 9512, Umatilla County, Oregon",1003,884,119,1003,268,735,1003,0,25,29,0,15,70,39,96,32,143,212,113,124,29,59,17,41,059,951200,1,410599512001
"Block Group 3, Census Tract 9518, Lincoln County, Oregon",452,306,146,452,126,326,452,35,22,15,39,14,23,5,26,88,34,48,41,11,0,14,37,41,041,951800,3,410419518003
"Block Group 3, Census Tract 107.02, Marion County, Oregon",1094,679,415,1094,61,1033,1094,63,40,91,47,37,37,17,45,17,66,96,207,106,112,71,42,41,047,010702,3,410470107023
"Block Group 3, Census Tract 108.01, Marion County, Oregon",524,314,210,524,62,462,524,0,76,0,0,46,10,0,0,0,72,42,83,56,37,102,0,41,047,010801,3,410470108013
"Block Group 4, Census Tract 216.01, Clackamas County, Oregon",335,267,68,335,27,308,335,38,0,19,19,0,11,0,0,0,48,98,22,26,54,0,0,41,005,021601,4,410050216014
"Block Group 3, Census Tract 236, Clackamas County, Oregon",455,322,133,455,109,346,455,36,17,24,0,30,41,27,11,9,32,25,93,32,20,22,36,41,005,023600,3,410050236003
"Block Group 2, Census Tract 236, Clackamas County, Oregon",501,354,147,501,96,405,501,0,21,8,49,0,34,21,39,34,7,37,51,113,30,32,25,41,005,023600,2,410050236002
"Block Group 1, Census Tract 243.02, Clackamas County, Oregon",573,405,168,573,68,505,573,45,16,16,15,0,19,0,0,13,15,86,101,15,64,86,82,41,005,024302,1,410050243021
"Block Group 2, Census Tract 212, Clackamas County, Oregon",277,257,20,277,33,244,277,10,0,0,8,0,6,25,0,0,15,51,93,33,12,11,13,41,005,021200,2,410050212002
"Block Group 3, Census Tract 224, Clackamas County, Oregon",255,214,41,255,24,231,255,0,0,0,7,0,8,8,33,8,42,52,25,38,13,21,0,41,005,022400,3,410050224003
"Block Group 1, Census Tract 9717, Klamath County, Oregon",493,376,117,493,251,242,493,88,74,55,0,34,0,11,10,20,52,28,27,29,0,58,7,41,035,971700,1,410359717001
"Block Group 4, Census Tract 9717, Klamath County, Oregon",230,174,56,230,143,87,230,11,22,54,5,22,21,9,11,0,15,60,0,0,0,0,0,41,035,971700,4,410359717004
"Block Group 2, Census Tract 9710, Klamath County, Oregon",650,536,114,650,35,615,650,16,8,14,32,33,15,10,19,32,58,37,80,161,40,46,49,41,035,971000,2,410359710002
"Block Group 1, Census Tract 9601, Wallowa County, Oregon",918,658,260,918,136,782,918,67,26,83,40,52,21,29,42,16,88,102,102,116,35,77,22,41,063,960100,1,410639601001
"Block Group 1, Census Tract 327, Washington County, Oregon",465,352,113,465,0,465,465,13,0,0,10,14,18,0,10,41,44,50,64,22,34,56,89,41,067,032700,1,410670327001
"Block Group 1, Census Tract 318.04, Washington County, Oregon",819,737,82,819,48,771,819,0,0,0,0,0,10,24,22,44,0,117,182,77,66,129,148,41,067,031804,1,410670318041
"Block Group 2, Census Tract 61, Multnomah County, Oregon",519,378,141,519,76,443,519,93,5,11,12,23,14,0,30,14,56,45,38,39,32,19,88,41,051,006100,2,410510061002
"Block Group 2, Census Tract 62, Multnomah County, Oregon",352,291,61,352,0,352,352,0,0,7,0,0,19,0,12,9,30,36,38,28,19,50,104,41,051,006200,2,410510062002
"Block Group 2, Census Tract 66.01, Multnomah County, Oregon",426,369,57,426,6,420,426,0,0,6,7,0,6,9,6,20,10,35,97,7,66,69,88,41,051,006601,2,410510066012
"Block Group 1, Census Tract 104.05, Multnomah County, Oregon",697,535,162,697,54,643,697,32,0,0,58,33,0,21,51,14,80,63,92,124,33,67,29,41,051,010405,1,410510104051
"Block Group 1, Census Tract 9601, Gilliam County, Oregon",354,288,66,354,85,269,354,17,21,12,7,20,31,21,14,17,21,33,83,34,14,6,3,41,021,960100,1,410219601001
"Block Group 2, Census Tract 9501, Hood River County, Oregon",316,296,20,316,83,233,316,0,0,21,0,0,13,40,8,23,10,49,17,67,34,15,19,41,027,950100,2,410279501002
"Block Group 4, Census Tract 9501, Hood River County, Oregon",316,252,64,316,40,276,316,0,0,14,10,56,0,0,41,19,31,10,12,33,52,28,10,41,027,950100,4,410279501004
"Block Group 4, Census Tract 9502, Hood River County, Oregon",813,750,63,813,42,771,813,0,0,47,67,0,0,107,0,24,50,120,46,146,79,54,73,41,027,950200,4,410279502004
"Block Group 2, Census Tract 9502, Hood River County, Oregon",393,323,70,393,65,328,393,15,0,0,0,0,45,0,0,31,17,37,136,50,14,0,48,41,027,950200,2,410279502002
"Block Group 6, Census Tract 9503, Hood River County, Oregon",659,410,249,659,127,532,659,16,61,141,18,24,32,4,21,0,80,67,43,86,0,28,38,41,027,950300,6,410279503006
"Block Group 4, Census Tract 9503, Hood River County, Oregon",338,238,100,338,21,317,338,21,34,0,0,33,0,11,0,16,23,61,25,48,19,10,37,41,027,950300,4,410279503004
"Block Group 4, Census Tract 9504, Hood River County, Oregon",130,98,32,130,7,123,130,0,5,0,0,0,0,21,8,5,20,31,0,14,0,20,6,41,027,950400,4,410279504004
"Block Group 2, Census Tract 10.01, Benton County, Oregon",668,464,204,668,204,464,668,107,71,88,29,79,10,68,12,19,124,8,8,9,30,0,6,41,003,001001,2,410030010012
"Block Group 2, Census Tract 205.01, Clackamas County, Oregon",1310,1018,292,1310,104,1206,1310,78,95,64,44,24,30,39,0,45,79,84,109,125,107,65,322,41,005,020501,2,410050205012
"Block Group 3, Census Tract 205.04, Clackamas County, Oregon",1139,869,270,1139,79,1060,1139,0,24,72,8,67,34,46,23,61,38,105,80,150,144,111,176,41,005,020504,3,410050205043
"Block Group 3, Census Tract 212, Clackamas County, Oregon",734,574,160,734,140,594,734,95,40,21,11,23,36,100,36,55,65,27,121,69,35,0,0,41,005,021200,3,410050212003
"Block Group 3, Census Tract 12, Deschutes County, Oregon",933,715,218,933,25,908,933,0,14,30,82,34,12,16,17,45,60,137,111,48,187,53,87,41,017,001200,3,410170012003
"Block Group 2, Census Tract 98.04, Multnomah County, Oregon",407,270,137,407,111,296,407,82,0,0,10,9,10,9,26,21,39,62,61,27,6,32,13,41,051,009804,2,410510098042
"Block Group 2, Census Tract 95.02, Multnomah County, Oregon",364,268,96,364,19,345,364,20,0,0,0,13,0,0,8,8,46,31,73,51,12,68,34,41,051,009502,2,410510095022
"Block Group 1, Census Tract 104.07, Multnomah County, Oregon",862,718,144,862,50,812,862,0,42,15,0,30,39,15,29,26,55,75,126,117,113,96,84,41,051,010407,1,410510104071
"Block Group 1, Census Tract 20, Multnomah County, Oregon",698,641,57,698,0,698,698,82,14,17,47,26,68,39,22,45,101,70,78,0,70,19,0,41,051,002000,1,410510020001
"Block Group 1, Census Tract 317.03, Washington County, Oregon",566,464,102,566,158,408,566,0,22,9,22,7,9,0,39,77,76,69,100,60,10,30,36,41,067,031703,1,410670317031
"Block Group 1, Census Tract 320.01, Washington County, Oregon",1389,1152,237,1389,127,1262,1389,56,17,46,35,52,34,128,41,41,71,120,225,173,101,110,139,41,067,032001,1,410670320011
"Block Group 5, Census Tract 20, Multnomah County, Oregon",738,697,41,738,77,661,738,44,0,47,13,116,20,16,32,52,52,131,37,20,40,41,77,41,051,002000,5,410510020005
"Block Group 2, Census Tract 31, Multnomah County, Oregon",538,478,60,538,62,476,538,17,10,7,20,0,13,17,0,12,87,34,100,42,89,42,48,41,051,003100,2,410510031002
"Block Group 2, Census Tract 46.02, Multnomah County, Oregon",404,343,61,404,0,404,404,0,19,6,6,0,0,0,0,0,12,6,17,38,12,70,218,41,051,004602,2,410510046022
"Block Group 2, Census Tract 69, Multnomah County, Oregon",498,381,117,498,12,486,498,18,0,0,21,0,0,9,0,0,0,10,17,33,83,62,245,41,051,006900,2,410510069002
"Block Group 1, Census Tract 30, Multnomah County, Oregon",486,442,44,486,77,409,486,0,9,39,0,0,0,0,0,6,56,31,44,27,95,131,48,41,051,003000,1,410510030001
"Block Group 1, Census Tract 83.01, Multnomah County, Oregon",727,363,364,727,363,364,727,216,101,53,18,43,20,26,27,11,37,29,111,14,21,0,0,41,051,008301,1,410510083011
"Block Group 1, Census Tract 335, Washington County, Oregon",326,241,85,326,40,286,326,18,15,0,8,0,6,15,0,6,27,16,70,55,29,49,12,41,067,033500,1,410670335001
"Block Group 1, Census Tract 304.01, Washington County, Oregon",450,218,232,450,64,386,450,15,0,13,82,36,11,41,10,69,104,37,13,19,0,0,0,41,067,030401,1,410670304011
"Block Group 3, Census Tract 305.02, Washington County, Oregon",506,442,64,506,58,448,506,23,17,17,10,25,47,9,23,36,58,22,43,69,11,35,61,41,067,030502,3,410670305023
"Block Group 4, Census Tract 305.01, Washington County, Oregon",381,325,56,381,35,346,381,0,0,0,0,14,0,19,16,0,28,89,18,62,28,90,17,41,067,030501,4,410670305014
"Block Group 1, Census Tract 307, Washington County, Oregon",320,208,112,320,90,230,320,39,43,13,42,9,19,9,18,12,8,49,32,7,10,4,6,41,067,030700,1,410670307001
"Block Group 3, Census Tract 315.04, Washington County, Oregon",602,602,0,602,31,571,602,0,0,15,13,35,47,65,35,16,27,206,53,43,13,17,17,41,067,031504,3,410670315043
"Block Group 1, Census Tract 316.12, Washington County, Oregon",1519,1374,145,1519,206,1313,1519,64,41,56,73,7,20,32,44,28,113,200,363,180,209,82,7,41,067,031612,1,410670316121
"Block Group 1, Census Tract 316.09, Washington County, Oregon",1203,1025,178,1203,85,1118,1203,28,14,0,0,0,32,15,46,0,181,158,145,201,62,174,147,41,067,031609,1,410670316091
"Block Group 1, Census Tract 317.05, Washington County, Oregon",502,502,0,502,74,428,502,27,11,10,21,20,8,0,36,61,35,53,111,22,46,32,9,41,067,031705,1,410670317051
"Block Group 2, Census Tract 10.02, Lane County, Oregon",548,305,243,548,191,357,548,67,70,57,61,38,17,28,15,9,28,17,17,61,26,22,15,41,039,001002,2,410390010022
"Block Group 1, Census Tract 18.04, Lane County, Oregon",341,261,80,341,36,305,341,0,3,10,24,18,28,11,0,2,21,34,79,65,0,33,13,41,039,001804,1,410390018041
"Block Group 3, Census Tract 19.02, Lane County, Oregon",902,801,101,902,139,763,902,0,0,22,122,72,42,37,52,47,112,210,186,0,0,0,0,41,039,001902,3,410390019023
"Block Group 4, Census Tract 19.02, Lane County, Oregon",341,271,70,341,145,196,341,39,15,38,0,29,0,0,0,23,42,60,64,14,0,0,17,41,039,001902,4,410390019024
"Block Group 2, Census Tract 4.04, Lane County, Oregon",384,283,101,384,80,304,384,8,49,15,0,0,17,0,10,14,84,18,24,19,80,9,37,41,039,000404,2,410390004042
"Block Group 2, Census Tract 7.02, Lane County, Oregon",536,262,274,536,11,525,536,15,19,40,14,14,9,28,28,16,62,64,63,40,65,25,34,41,039,000702,2,410390007022
"Block Group 4, Census Tract 9.02, Lane County, Oregon",436,223,213,436,70,366,436,20,55,0,19,8,51,34,22,11,17,20,81,36,26,0,36,41,039,000902,4,410390009024
"Block Group 2, Census Tract 9.02, Lane County, Oregon",507,417,90,507,39,468,507,10,9,0,14,0,7,27,0,10,73,81,173,26,28,28,21,41,039,000902,2,410390009022
"Block Group 2, Census Tract 9703, Malheur County, Oregon",321,162,159,321,40,281,321,25,17,22,23,18,10,0,30,7,29,17,47,41,11,0,24,41,045,970300,2,410459703002
"Block Group 3, Census Tract 9704, Malheur County, Oregon",258,209,49,258,215,43,258,12,35,42,38,45,9,5,0,24,22,26,0,0,0,0,0,41,045,970400,3,410459704003
"Block Group 2, Census Tract 9704, Malheur County, Oregon",421,329,92,421,155,266,421,68,21,68,41,8,22,7,7,0,0,53,94,32,0,0,0,41,045,970400,2,410459704002
"Block Group 1, Census Tract 3610, Josephine County, Oregon",373,175,198,373,59,314,373,11,30,27,24,13,19,20,39,46,26,34,46,18,12,8,0,41,033,361000,1,410333610001
"Block Group 3, Census Tract 3616, Josephine County, Oregon",446,119,327,446,154,292,446,51,57,23,76,16,50,11,12,10,64,26,8,13,0,0,29,41,033,361600,3,410333616003
"Block Group 6, Census Tract 3616, Josephine County, Oregon",479,290,189,479,26,453,479,0,12,0,30,27,135,66,14,0,31,66,68,0,16,0,14,41,033,361600,6,410333616006
"Block Group 1, Census Tract 3608, Josephine County, Oregon",675,518,157,675,212,463,675,0,19,92,62,53,36,0,0,19,68,147,113,37,0,29,0,41,033,360800,1,410333608001
"Block Group 3, Census Tract 3605, Josephine County, Oregon",1134,594,540,1134,355,779,1134,170,79,113,47,56,106,62,17,60,34,89,160,95,13,33,0,41,033,360500,3,410333605003
"Block Group 2, Census Tract 9504, Lincoln County, Oregon",895,580,315,895,311,584,895,32,130,70,63,101,80,43,38,31,129,78,45,10,31,9,5,41,041,950400,2,410419504002
"Block Group 1, Census Tract 203.02, Polk County, Oregon",399,281,118,399,65,334,399,19,0,41,33,0,0,20,0,13,0,0,81,72,30,60,30,41,053,020302,1,410530203021
"Block Group 5, Census Tract 203.02, Polk County, Oregon",1237,1043,194,1237,251,986,1237,119,0,38,21,53,80,46,60,25,159,179,317,88,28,13,11,41,053,020302,5,410530203025
"Block Group 3, Census Tract 304, Yamhill County, Oregon",476,410,66,476,47,429,476,15,2,5,4,6,10,10,14,42,58,47,63,78,50,22,50,41,071,030400,3,410710304003
"Block Group 4, Census Tract 304, Yamhill County, Oregon",506,442,64,506,47,459,506,56,2,0,0,0,61,0,0,24,8,131,86,98,0,6,34,41,071,030400,4,410710304004
"Block Group 1, Census Tract 307.01, Yamhill County, Oregon",1024,785,239,1024,165,859,1024,73,14,106,27,15,61,56,71,65,90,181,112,64,0,62,27,41,071,030701,1,410710307011
"Block Group 2, Census Tract 305.02, Yamhill County, Oregon",571,399,172,571,176,395,571,73,17,23,10,58,19,38,50,13,24,155,15,45,22,9,0,41,071,030502,2,410710305022
"Block Group 4, Census Tract 305.02, Yamhill County, Oregon",364,278,86,364,103,261,364,16,8,36,13,25,30,0,16,47,25,70,30,0,0,17,31,41,071,030502,4,410710305024
"Block Group 1, Census Tract 309, Yamhill County, Oregon",828,698,130,828,203,625,828,24,4,38,22,27,18,65,29,68,91,115,137,85,50,30,25,41,071,030900,1,410710309001
"Block Group 4, Census Tract 107.01, Marion County, Oregon",972,786,186,972,151,821,972,11,85,26,42,33,32,60,95,73,111,179,83,47,65,17,13,41,047,010701,4,410470107014
"Block Group 2, Census Tract 15.03, Marion County, Oregon",706,465,241,706,256,450,706,124,85,8,27,53,58,27,15,21,119,63,25,19,0,41,21,41,047,001503,2,410470015032
"Block Group 4, Census Tract 16.01, Marion County, Oregon",386,311,75,386,73,313,386,0,0,13,9,25,33,0,0,33,35,74,56,56,0,52,0,41,047,001601,4,410470016014
"Block Group 3, Census Tract 16.01, Marion County, Oregon",787,566,221,787,73,714,787,0,63,99,69,69,18,0,0,17,87,107,88,18,64,88,0,41,047,001601,3,410470016013
"Block Group 2, Census Tract 16.03, Marion County, Oregon",642,490,152,642,48,594,642,18,0,0,92,0,8,20,0,35,64,191,79,25,54,22,34,41,047,001603,2,410470016032
"Block Group 4, Census Tract 16.03, Marion County, Oregon",681,548,133,681,85,596,681,72,10,0,0,0,0,18,50,15,73,150,108,129,0,56,0,41,047,001603,4,410470016034
"Block Group 3, Census Tract 9706, Union County, Oregon",338,285,53,338,43,295,338,10,15,21,27,0,9,39,35,0,16,67,45,19,23,12,0,41,061,970600,3,410619706003
"Block Group 2, Census Tract 307, Linn County, Oregon",380,229,151,380,47,333,380,10,0,36,0,0,29,16,12,45,9,33,78,34,22,45,11,41,043,030700,2,410430307002
"Block Group 1, Census Tract 306, Linn County, Oregon",336,215,121,336,0,336,336,13,0,0,0,42,75,0,0,0,28,32,70,32,0,15,29,41,043,030600,1,410430306001
"Block Group 2, Census Tract 59, Multnomah County, Oregon",505,369,136,505,0,505,505,17,0,0,48,45,0,0,0,33,51,47,49,29,28,78,80,41,051,005900,2,410510059002
"Block Group 3, Census Tract 59, Multnomah County, Oregon",611,482,129,611,0,611,611,0,0,0,14,0,0,17,14,0,57,55,93,102,75,73,111,41,051,005900,3,410510059003
"Block Group 1, Census Tract 3605, Josephine County, Oregon",286,221,65,286,90,196,286,28,52,43,0,13,18,0,0,20,0,23,18,37,14,0,20,41,033,360500,1,410333605001
"Block Group 3, Census Tract 9702, Klamath County, Oregon",850,431,419,850,225,625,850,77,73,34,25,129,75,62,25,71,14,92,128,34,0,11,0,41,035,970200,3,410359702003
"Block Group 2, Census Tract 9708, Klamath County, Oregon",374,306,68,374,36,338,374,9,5,21,21,0,14,15,30,13,23,83,32,45,15,24,24,41,035,970800,2,410359708002
"Block Group 2, Census Tract 105.02, Marion County, Oregon",1010,756,254,1010,120,890,1010,30,65,18,0,14,14,104,92,37,54,50,97,140,135,37,123,41,047,010502,2,410470105022
"Block Group 2, Census Tract 17.02, Marion County, Oregon",621,440,181,621,149,472,621,8,17,51,32,97,19,7,58,14,30,103,120,18,29,18,0,41,047,001702,2,410470017022
"Block Group 1, Census Tract 11, Marion County, Oregon",384,289,95,384,82,302,384,8,0,18,28,17,0,10,19,25,19,50,48,33,57,52,0,41,047,001100,1,410470011001
"Block Group 2, Census Tract 6, Marion County, Oregon",682,622,60,682,264,418,682,30,56,41,146,13,32,56,18,31,47,23,29,104,15,30,11,41,047,000600,2,410470006002
"Block Group 2, Census Tract 17.01, Marion County, Oregon",981,680,301,981,263,718,981,52,32,100,38,93,31,83,59,108,134,38,34,81,48,42,8,41,047,001701,2,410470017012
"Block Group 1, Census Tract 17.03, Marion County, Oregon",385,289,96,385,30,355,385,0,0,31,11,9,0,0,25,27,37,11,55,46,58,43,32,41,047,001703,1,410470017031
"Block Group 2, Census Tract 24, Marion County, Oregon",935,678,257,935,67,868,935,47,0,4,30,34,43,96,22,14,0,108,79,106,44,154,154,41,047,002400,2,410470024002
"Block Group 1, Census Tract 103.04, Marion County, Oregon",397,326,71,397,129,268,397,61,0,93,0,0,29,0,10,55,29,10,9,25,45,0,31,41,047,010304,1,410470103041
"Block Group 1, Census Tract 104, Marion County, Oregon",160,73,87,160,7,153,160,7,15,16,0,0,44,0,0,0,7,40,11,0,0,7,13,41,047,010400,1,410470104001
"Block Group 2, Census Tract 9512, Clatsop County, Oregon",480,336,144,480,72,408,480,8,22,20,36,10,46,29,8,11,24,84,86,69,6,8,13,41,007,951200,2,410079512002
"Block Group 2, Census Tract 9513, Clatsop County, Oregon",410,299,111,410,30,380,410,60,0,13,6,11,16,11,10,37,16,42,48,41,24,41,34,41,007,951300,2,410079513002
"Block Group 3, Census Tract 9505, Clatsop County, Oregon",956,759,197,956,142,814,956,62,15,19,24,9,82,61,0,94,128,48,187,117,35,67,8,41,007,950500,3,410079505003
"Block Group 4, Census Tract 9502, Clatsop County, Oregon",265,228,37,265,51,214,265,0,20,0,29,22,30,25,0,26,10,45,40,10,8,0,0,41,007,950200,4,410079502004
"Block Group 2, Census Tract 9503, Clatsop County, Oregon",51,41,10,51,0,51,51,0,0,0,0,0,0,0,0,0,18,33,0,0,0,0,0,41,007,950300,2,410079503002
"Block Group 3, Census Tract 9503, Clatsop County, Oregon",585,351,234,585,189,396,585,55,42,40,66,67,12,34,52,47,11,35,35,57,0,32,0,41,007,950300,3,410079503003
"Block Group 2, Census Tract 9506, Clatsop County, Oregon",403,305,98,403,39,364,403,7,0,22,20,30,0,33,9,17,24,37,80,50,45,8,21,41,007,950600,2,410079506002
"Block Group 6, Census Tract 9509, Clatsop County, Oregon",339,274,65,339,44,295,339,0,0,36,17,16,61,0,28,0,42,101,38,0,0,0,0,41,007,950900,6,410079509006
"Block Group 5, Census Tract 9509, Clatsop County, Oregon",309,268,41,309,16,293,309,0,15,0,45,0,20,39,0,16,0,81,33,23,37,0,0,41,007,950900,5,410079509005
"Block Group 1, Census Tract 28.01, Multnomah County, Oregon",643,519,124,643,35,608,643,7,9,0,10,16,9,24,32,22,58,58,101,78,45,61,113,41,051,002801,1,410510028011
"Block Group 4, Census Tract 5.02, Multnomah County, Oregon",445,355,90,445,121,324,445,58,9,10,34,10,24,22,34,10,23,92,42,36,6,35,0,41,051,000502,4,410510005024
"Block Group 3, Census Tract 5.02, Multnomah County, Oregon",322,296,26,322,49,273,322,12,0,0,0,0,17,19,14,9,35,60,81,32,33,10,0,41,051,000502,3,410510005023
"Block Group 1, Census Tract 8.02, Multnomah County, Oregon",412,399,13,412,102,310,412,13,0,17,0,38,0,0,54,18,17,99,45,56,0,41,14,41,051,000802,1,410510008021
"Block Group 1, Census Tract 10, Multnomah County, Oregon",377,362,15,377,87,290,377,19,0,0,18,32,0,0,51,0,14,33,82,46,16,30,36,41,051,001000,1,410510010001
"Block Group 5, Census Tract 10, Multnomah County, Oregon",580,492,88,580,82,498,580,33,15,32,13,49,0,0,30,16,54,67,61,94,32,84,0,41,051,001000,5,410510010005
"Block Group 1, Census Tract 12.01, Multnomah County, Oregon",444,424,20,444,16,428,444,0,0,67,17,34,14,37,0,0,53,52,101,12,19,18,20,41,051,001201,1,410510012011
"Block Group 3, Census Tract 12.02, Multnomah County, Oregon",395,356,39,395,9,386,395,9,0,19,12,12,16,25,9,8,23,30,41,16,28,67,80,41,051,001202,3,410510012023
"Block Group 4, Census Tract 13.01, Jackson County, Oregon",727,551,176,727,175,552,727,17,25,60,47,0,23,40,72,47,30,118,98,86,17,28,19,41,029,001301,4,410290013014
"Block Group 1, Census Tract 21, Jackson County, Oregon",867,616,251,867,117,750,867,38,40,68,40,52,52,20,62,16,99,49,72,99,82,32,46,41,029,002100,1,410290021001
"Block Group 4, Census Tract 29, Jackson County, Oregon",483,250,233,483,185,298,483,48,71,65,46,36,23,53,49,5,11,22,49,5,0,0,0,41,029,002900,4,410290029004
"Block Group 3, Census Tract 29, Jackson County, Oregon",651,488,163,651,94,557,651,12,20,37,39,22,45,44,37,22,53,80,90,36,75,39,0,41,029,002900,3,410290029003
"Block Group 4, Census Tract 18, Jackson County, Oregon",1004,707,297,1004,369,635,1004,204,125,36,47,116,98,70,16,34,23,95,85,14,18,12,11,41,029,001800,4,410290018004
"Block Group 1, Census Tract 20, Jackson County, Oregon",634,436,198,634,82,552,634,55,49,59,18,24,99,20,8,27,42,17,97,18,9,37,55,41,029,002000,1,410290020001
"Block Group 1, Census Tract 26, Jackson County, Oregon",566,315,251,566,144,422,566,67,62,8,41,19,62,0,25,17,23,63,86,55,14,7,17,41,029,002600,1,410290026001
"Block Group 2, Census Tract 28, Jackson County, Oregon",960,692,268,960,144,816,960,48,20,36,67,75,74,40,47,32,116,138,92,46,71,22,36,41,029,002800,2,410290028002
"Block Group 2, Census Tract 8, Jackson County, Oregon",954,556,398,954,209,745,954,87,70,122,35,17,29,78,21,0,52,53,105,101,77,107,0,41,029,000800,2,410290008002
"Block Group 3, Census Tract 7, Jackson County, Oregon",225,141,84,225,20,205,225,0,0,0,0,14,0,12,0,49,82,15,12,18,12,11,0,41,029,000700,3,410290007003
"Block Group 3, Census Tract 500.01, Douglas County, Oregon",545,383,162,545,162,383,545,73,31,30,15,15,30,49,21,45,68,52,67,15,11,6,17,41,019,050001,3,410190500013
"Block Group 2, Census Tract 1800, Douglas County, Oregon",240,129,111,240,86,154,240,62,10,34,3,0,14,9,19,6,19,24,5,18,0,17,0,41,019,180000,2,410191800002
"Block Group 3, Census Tract 1800, Douglas County, Oregon",278,213,65,278,42,236,278,0,18,0,14,29,8,35,6,9,15,108,16,13,7,0,0,41,019,180000,3,410191800003
"Block Group 5, Census Tract 9714, Klamath County, Oregon",583,472,111,583,88,495,583,16,12,0,14,69,0,14,48,67,69,59,90,13,94,18,0,41,035,971400,5,410359714005
"Block Group 4, Census Tract 9714, Klamath County, Oregon",492,429,63,492,52,440,492,28,0,12,15,28,0,41,28,0,34,140,54,91,21,0,0,41,035,971400,4,410359714004
"Block Group 3, Census Tract 9715, Klamath County, Oregon",252,107,145,252,47,205,252,41,9,10,51,16,11,0,0,0,53,10,8,11,0,32,0,41,035,971500,3,410359715003
"Block Group 2, Census Tract 9718, Klamath County, Oregon",306,276,30,306,181,125,306,41,0,27,40,0,6,21,20,25,7,81,12,14,0,4,8,41,035,971800,2,410359718002
"Block Group 1, Census Tract 102, Benton County, Oregon",761,623,138,761,23,738,761,9,10,15,12,22,28,34,40,12,56,100,151,50,83,54,85,41,003,010200,1,410030102001
"Block Group 4, Census Tract 11.01, Benton County, Oregon",224,224,0,224,16,208,224,19,18,9,29,35,16,0,8,0,9,31,37,0,13,0,0,41,003,001101,4,410030011014
"Block Group 5, Census Tract 317.04, Washington County, Oregon",312,244,68,312,0,312,312,0,0,0,0,16,51,37,0,0,0,18,99,17,16,58,0,41,067,031704,5,410670317045
"Block Group 3, Census Tract 317.04, Washington County, Oregon",337,279,58,337,39,298,337,0,0,18,0,0,0,56,0,35,0,49,38,103,38,0,0,41,067,031704,3,410670317043
"Block Group 3, Census Tract 11.01, Benton County, Oregon",221,221,0,221,10,211,221,59,0,0,0,31,49,19,0,21,0,32,0,0,0,10,0,41,003,001101,3,410030011013
"Block Group 2, Census Tract 9702, Columbia County, Oregon",497,373,124,497,171,326,497,145,17,0,12,0,61,29,27,30,23,9,51,7,68,0,18,41,009,970200,2,410099702002
"Block Group 1, Census Tract 9708, Columbia County, Oregon",708,468,240,708,363,345,708,181,29,105,0,43,0,58,21,16,23,41,92,59,40,0,0,41,009,970800,1,410099708001
"Block Group 5, Census Tract 9703, Columbia County, Oregon",364,156,208,364,70,294,364,38,0,25,52,16,40,5,55,0,98,16,4,0,4,6,5,41,009,970300,5,410099703005
"Block Group 1, Census Tract 9703, Columbia County, Oregon",427,296,131,427,73,354,427,18,17,15,33,14,16,29,0,19,47,32,66,43,13,45,20,41,009,970300,1,410099703001
"Block Group 1, Census Tract 21.02, Lane County, Oregon",1029,800,229,1029,328,701,1029,33,179,65,66,194,63,82,26,44,46,169,25,20,0,0,17,41,039,002102,1,410390021021
"Block Group 1, Census Tract 9603, Tillamook County, Oregon",388,234,154,388,67,321,388,34,0,45,0,54,0,28,57,5,21,0,17,63,23,22,19,41,057,960300,1,410579603001
"Block Group 3, Census Tract 91.02, Multnomah County, Oregon",365,139,226,365,162,203,365,31,0,26,41,26,22,0,0,0,156,0,0,63,0,0,0,41,051,009102,3,410510091023
"Block Group 3, Census Tract 31.01, Lane County, Oregon",1150,887,263,1150,164,986,1150,95,30,77,53,14,64,9,51,73,95,94,86,90,128,69,122,41,039,003101,3,410390031013
"Block Group 4, Census Tract 221.01, Clackamas County, Oregon",527,436,91,527,50,477,527,17,0,0,0,14,0,0,77,37,0,140,63,30,44,10,95,41,005,022101,4,410050221014
"Block Group 4, Census Tract 227.02, Clackamas County, Oregon",298,216,82,298,0,298,298,29,15,0,0,14,0,0,0,0,0,0,53,16,40,32,99,41,005,022702,4,410050227024
"Block Group 3, Census Tract 98.03, Multnomah County, Oregon",556,464,92,556,113,443,556,13,28,25,0,35,56,0,21,0,85,95,68,20,25,85,0,41,051,009803,3,410510098033
"Block Group 3, Census Tract 20, Deschutes County, Oregon",1407,1140,267,1407,115,1292,1407,22,12,13,90,59,159,36,61,11,124,245,296,200,20,30,29,41,017,002000,3,410170020003
"Block Group 1, Census Tract 21, Deschutes County, Oregon",921,631,290,921,51,870,921,33,0,21,20,33,51,23,42,18,21,41,126,141,32,183,136,41,017,002100,1,410170021001
"Block Group 3, Census Tract 16, Deschutes County, Oregon",1439,1184,255,1439,207,1232,1439,102,91,31,0,74,60,88,33,21,250,205,264,132,36,38,14,41,017,001600,3,410170016003
"Block Group 3, Census Tract 11, Deschutes County, Oregon",2642,2241,401,2642,230,2412,2642,43,0,52,115,191,43,85,187,26,199,327,380,319,277,219,179,41,017,001100,3,410170011003
"Block Group 1, Census Tract 7, Deschutes County, Oregon",698,539,159,698,101,597,698,44,46,0,32,5,0,10,0,0,28,143,182,37,29,97,45,41,017,000700,1,410170007001
"Block Group 1, Census Tract 333.01, Washington County, Oregon",1321,1119,202,1321,141,1180,1321,93,0,8,57,50,11,43,70,16,137,128,315,119,140,96,38,41,067,033301,1,410670333011
"Block Group 2, Census Tract 241, Clackamas County, Oregon",629,430,199,629,73,556,629,21,10,28,21,9,53,34,0,65,70,100,105,67,17,19,10,41,005,024100,2,410050241002
"Block Group 2, Census Tract 206, Clackamas County, Oregon",1168,1055,113,1168,23,1145,1168,22,23,24,11,19,0,19,20,39,35,111,143,94,147,113,348,41,005,020600,2,410050206002
"Block Group 2, Census Tract 203.03, Clackamas County, Oregon",564,322,242,564,10,554,564,16,0,70,26,47,0,34,0,35,55,28,51,10,66,35,91,41,005,020303,2,410050203032
"Block Group 1, Census Tract 208, Clackamas County, Oregon",794,555,239,794,72,722,794,31,23,9,63,23,58,54,69,65,96,116,40,45,30,45,27,41,005,020800,1,410050208001
"Block Group 1, Census Tract 9708, Klamath County, Oregon",569,379,190,569,101,468,569,53,26,27,47,24,16,29,28,27,32,73,83,48,33,8,15,41,035,970800,1,410359708001
"Block Group 1, Census Tract 9716, Klamath County, Oregon",203,120,83,203,123,80,203,9,34,49,9,0,0,81,0,0,0,21,0,0,0,0,0,41,035,971600,1,410359716001
"Block Group 1, Census Tract 9712, Klamath County, Oregon",462,313,149,462,234,228,462,94,21,45,57,26,0,59,33,33,16,36,25,8,9,0,0,41,035,971200,1,410359712001
"Block Group 2, Census Tract 9713, Klamath County, Oregon",270,223,47,270,81,189,270,34,0,37,0,28,0,45,0,0,14,0,13,34,50,15,0,41,035,971300,2,410359713002
"Block Group 4, Census Tract 9713, Klamath County, Oregon",238,197,41,238,26,212,238,0,0,41,15,0,0,0,0,15,16,20,30,67,34,0,0,41,035,971300,4,410359713004
"Block Group 3, Census Tract 13, Deschutes County, Oregon",654,477,177,654,82,572,654,16,20,25,32,85,0,30,38,29,21,44,55,125,42,0,92,41,017,001300,3,410170013003
"Block Group 2, Census Tract 14, Deschutes County, Oregon",315,283,32,315,22,293,315,14,39,0,0,56,38,15,12,0,19,77,36,0,0,0,9,41,017,001400,2,410170014002
"Block Group 4, Census Tract 15, Deschutes County, Oregon",375,340,35,375,34,341,375,16,0,16,0,135,0,15,0,9,31,0,51,57,10,20,15,41,017,001500,4,410170015004
"Block Group 2, Census Tract 15, Deschutes County, Oregon",621,411,210,621,126,495,621,67,56,28,72,15,35,0,16,13,10,46,110,65,14,57,17,41,017,001500,2,410170015002
"Block Group 2, Census Tract 17, Deschutes County, Oregon",1042,873,169,1042,78,964,1042,32,72,103,124,43,52,33,57,21,45,87,238,58,28,32,17,41,017,001700,2,410170017002
"Block Group 4, Census Tract 20, Deschutes County, Oregon",772,645,127,772,91,681,772,75,0,0,27,14,31,104,38,43,144,26,147,31,22,0,70,41,017,002000,4,410170020004
"Block Group 2, Census Tract 9702, Union County, Oregon",548,371,177,548,70,478,548,24,7,52,30,16,4,27,32,24,68,46,102,54,40,19,3,41,061,970200,2,410619702002
"Block Group 3, Census Tract 9705, Union County, Oregon",481,369,112,481,36,445,481,26,14,34,12,18,11,33,60,49,16,41,78,31,9,49,0,41,061,970500,3,410619705003
"Block Group 3, Census Tract 9701, Union County, Oregon",220,147,73,220,39,181,220,4,13,37,15,10,7,3,16,23,12,17,45,7,5,6,0,41,061,970100,3,410619701003
"Block Group 3, Census Tract 9704, Union County, Oregon",322,249,73,322,147,175,322,38,8,12,21,34,8,92,0,23,27,20,34,0,0,0,5,41,061,970400,3,410619704003
"Block Group 2, Census Tract 9703, Columbia County, Oregon",310,215,95,310,78,232,310,11,12,4,4,16,48,31,0,0,8,38,18,13,51,4,52,41,009,970300,2,410099703002
"Block Group 2, Census Tract 9707, Columbia County, Oregon",246,202,44,246,84,162,246,27,0,0,21,18,27,0,23,0,26,11,58,9,17,9,0,41,009,970700,2,410099707002
"Block Group 2, Census Tract 56, Multnomah County, Oregon",429,312,117,429,23,406,429,127,22,0,15,20,0,0,0,0,128,94,23,0,0,0,0,41,051,005600,2,410510056002
"Block Group 3, Census Tract 324.04, Washington County, Oregon",396,298,98,396,0,396,396,0,0,11,0,56,0,12,0,0,0,58,129,67,28,16,19,41,067,032404,3,410670324043
"Block Group 1, Census Tract 314.04, Washington County, Oregon",660,577,83,660,110,550,660,0,0,0,32,20,41,103,22,50,23,57,132,60,47,58,15,41,067,031404,1,410670314041
"Block Group 1, Census Tract 34.02, Multnomah County, Oregon",675,555,120,675,131,544,675,11,66,44,31,31,9,0,0,10,56,31,37,143,43,100,63,41,051,003402,1,410510034021
"Block Group 3, Census Tract 35.01, Multnomah County, Oregon",380,339,41,380,24,356,380,16,0,21,0,15,14,14,0,20,32,15,41,57,53,44,38,41,051,003501,3,410510035013
"Block Group 5, Census Tract 1, Lane County, Oregon",344,234,110,344,63,281,344,41,6,20,10,10,5,5,32,16,0,78,46,25,31,14,5,41,039,000100,5,410390001005
"Block Group 2, Census Tract 1, Lane County, Oregon",532,362,170,532,55,477,532,10,0,40,28,0,42,14,0,0,60,28,55,44,15,92,104,41,039,000100,2,410390001002
"Block Group 1, Census Tract 5, Lane County, Oregon",363,185,178,363,78,285,363,22,24,14,35,16,38,14,29,28,31,19,22,31,17,9,14,41,039,000500,1,410390005001
"Block Group 1, Census Tract 8, Lane County, Oregon",242,191,51,242,13,229,242,0,5,3,12,16,27,0,6,14,25,17,65,24,8,10,10,41,039,000800,1,410390008001
"Block Group 2, Census Tract 19.03, Lane County, Oregon",316,263,53,316,106,210,316,9,0,20,9,61,0,0,54,0,47,57,28,7,24,0,0,41,039,001903,2,410390019032
"Block Group 1, Census Tract 40, Lane County, Oregon",692,244,448,692,417,275,692,258,137,45,77,9,32,18,15,26,29,0,17,0,0,11,18,41,039,004000,1,410390040001
"Block Group 3, Census Tract 44.01, Lane County, Oregon",233,177,56,233,0,233,233,0,0,0,14,0,0,17,0,0,67,0,61,12,62,0,0,41,039,004401,3,410390044013
"Block Group 2, Census Tract 44.01, Lane County, Oregon",766,667,99,766,147,619,766,136,13,15,25,17,49,36,47,17,80,177,65,61,21,7,0,41,039,004401,2,410390044012
"Block Group 2, Census Tract 7, Coos County, Oregon",267,210,57,267,171,96,267,0,34,71,0,26,0,15,0,0,12,73,36,0,0,0,0,41,011,000700,2,410110007002
"Block Group 5, Census Tract 7, Coos County, Oregon",297,276,21,297,110,187,297,0,27,32,0,0,0,21,0,0,32,33,51,80,0,21,0,41,011,000700,5,410110007005
"Block Group 2, Census Tract 10, Coos County, Oregon",673,238,435,673,78,595,673,50,78,60,42,19,69,58,94,31,69,0,41,0,48,14,0,41,011,001000,2,410110010002
"Block Group 5, Census Tract 10, Coos County, Oregon",411,186,225,411,46,365,411,52,16,0,35,72,16,27,0,0,80,0,77,28,0,0,8,41,011,001000,5,410110010005
"Block Group 4, Census Tract 10, Coos County, Oregon",592,370,222,592,190,402,592,66,35,20,28,48,20,99,21,20,83,47,34,36,0,0,35,41,011,001000,4,410110010004
"Block Group 2, Census Tract 315.09, Washington County, Oregon",237,166,71,237,13,224,237,0,0,11,0,0,8,0,15,0,11,0,38,56,14,26,58,41,067,031509,2,410670315092
"Block Group 3, Census Tract 10.01, Jackson County, Oregon",1139,879,260,1139,120,1019,1139,59,48,38,30,76,40,84,28,83,66,161,230,88,46,32,30,41,029,001001,3,410290010013
"Block Group 4, Census Tract 7, Jackson County, Oregon",592,452,140,592,89,503,592,12,0,75,14,0,46,12,31,20,30,94,116,82,18,42,0,41,029,000700,4,410290007004
"Block Group 3, Census Tract 239.02, Clackamas County, Oregon",436,295,141,436,156,280,436,25,59,42,9,8,20,33,0,53,64,21,69,12,0,21,0,41,005,023902,3,410050239023
"Block Group 2, Census Tract 319.04, Washington County, Oregon",657,598,59,657,35,622,657,0,24,38,0,0,8,7,38,15,36,42,63,110,124,68,84,41,067,031904,2,410670319042
"Block Group 3, Census Tract 315.12, Washington County, Oregon",1318,1236,82,1318,143,1175,1318,41,0,14,68,0,67,38,24,48,59,85,234,116,139,268,117,41,067,031512,3,410670315123
"Block Group 4, Census Tract 9702, Morrow County, Oregon",159,115,44,159,19,140,159,0,0,0,10,16,26,14,7,8,7,25,5,34,7,0,0,41,049,970200,4,410499702004
"Block Group 3, Census Tract 9702, Morrow County, Oregon",324,250,74,324,50,274,324,0,27,11,6,14,28,83,36,0,25,40,19,6,4,25,0,41,049,970200,3,410499702003
"Block Group 3, Census Tract 313, Washington County, Oregon",615,567,48,615,183,432,615,32,30,59,72,65,17,0,34,37,0,43,80,11,54,21,60,41,067,031300,3,410670313003
"Block Group 3, Census Tract 103.06, Multnomah County, Oregon",424,366,58,424,65,359,424,20,0,0,13,21,56,11,16,39,9,100,29,38,39,11,22,41,051,010306,3,410510103063
"Block Group 2, Census Tract 205.05, Clackamas County, Oregon",439,351,88,439,21,418,439,11,0,0,12,0,0,0,31,0,35,20,52,62,46,88,82,41,005,020505,2,410050205052
"Block Group 2, Census Tract 204.03, Clackamas County, Oregon",412,337,75,412,0,412,412,51,0,10,0,6,10,24,0,0,8,14,19,20,14,67,169,41,005,020403,2,410050204032
"Block Group 3, Census Tract 221.05, Clackamas County, Oregon",890,708,182,890,61,829,890,13,0,0,78,0,41,0,0,60,15,61,166,57,162,141,96,41,005,022105,3,410050221053
"Block Group 2, Census Tract 221.08, Clackamas County, Oregon",921,769,152,921,272,649,921,120,56,17,0,61,30,118,34,71,32,48,209,46,9,37,33,41,005,022108,2,410050221082
"Block Group 2, Census Tract 222.06, Clackamas County, Oregon",1829,1540,289,1829,98,1731,1829,0,59,20,18,70,41,55,0,51,75,211,139,146,145,243,556,41,005,022206,2,410050222062
"Block Group 2, Census Tract 222.08, Clackamas County, Oregon",825,734,91,825,0,825,825,17,0,0,15,0,0,0,43,10,19,16,71,165,149,148,172,41,005,022208,2,410050222082
"Block Group 4, Census Tract 319.07, Washington County, Oregon",357,115,242,357,13,344,357,54,28,0,36,42,11,34,0,15,54,35,13,12,13,0,10,41,067,031907,4,410670319074
"Block Group 1, Census Tract 318.13, Washington County, Oregon",1156,950,206,1156,96,1060,1156,27,45,14,0,58,0,41,45,66,32,35,60,129,142,148,314,41,067,031813,1,410670318131
"Block Group 2, Census Tract 23.02, Lane County, Oregon",541,429,112,541,22,519,541,10,0,0,6,0,0,41,31,31,65,74,140,66,28,29,20,41,039,002302,2,410390023022
"Block Group 2, Census Tract 7.08, Lane County, Oregon",442,235,207,442,83,359,442,44,30,37,12,20,0,7,8,57,39,52,40,17,11,19,49,41,039,000708,2,410390007082
"Block Group 1, Census Tract 7.07, Lane County, Oregon",765,155,610,765,41,724,765,45,97,0,65,98,26,18,53,41,65,78,44,27,66,9,33,41,039,000707,1,410390007071
"Block Group 2, Census Tract 25.04, Lane County, Oregon",887,739,148,887,294,593,887,71,17,38,61,71,41,75,45,54,115,129,54,65,23,28,0,41,039,002504,2,410390025042
"Block Group 1, Census Tract 44.05, Lane County, Oregon",599,425,174,599,6,593,599,25,19,59,19,44,25,28,5,8,49,22,84,27,40,67,78,41,039,004405,1,410390044051
"Block Group 3, Census Tract 9602, Tillamook County, Oregon",348,262,86,348,103,245,348,25,35,18,17,8,6,10,22,12,66,49,30,26,18,3,3,41,057,960200,3,410579602003
"Block Group 1, Census Tract 95.01, Multnomah County, Oregon",1106,915,191,1106,260,846,1106,38,54,114,17,24,53,62,36,67,91,166,140,87,50,79,28,41,051,009501,1,410510095011
"Block Group 1, Census Tract 94, Multnomah County, Oregon",827,280,547,827,0,827,827,65,0,38,15,52,33,37,110,33,105,130,86,97,0,26,0,41,051,009400,1,410510094001
"Block Group 1, Census Tract 9703, Union County, Oregon",276,183,93,276,30,246,276,4,7,15,3,24,10,15,33,15,7,19,44,29,19,15,17,41,061,970300,1,410619703001
"Block Group 2, Census Tract 9707, Union County, Oregon",307,251,56,307,66,241,307,18,10,47,12,0,26,34,34,0,11,21,60,0,34,0,0,41,061,970700,2,410619707002
"Block Group 1, Census Tract 324.06, Washington County, Oregon",277,251,26,277,34,243,277,40,0,0,0,18,16,66,0,16,0,0,36,29,24,18,14,41,067,032406,1,410670324061
"Block Group 3, Census Tract 19, Multnomah County, Oregon",411,316,95,411,13,398,411,9,0,9,0,0,0,13,0,0,17,21,39,33,35,125,110,41,051,001900,3,410510019003
"Block Group 2, Census Tract 19, Multnomah County, Oregon",468,376,92,468,9,459,468,0,11,0,10,11,8,0,0,0,18,51,39,40,19,81,180,41,051,001900,2,410510019002
"Block Group 3, Census Tract 25.01, Multnomah County, Oregon",324,280,44,324,8,316,324,0,0,0,23,24,8,0,0,10,15,12,32,36,31,14,119,41,051,002501,3,410510025013
"Block Group 2, Census Tract 25.01, Multnomah County, Oregon",338,264,74,338,0,338,338,8,20,10,0,0,7,8,0,0,21,7,39,23,36,63,96,41,051,002501,2,410510025012
"Block Group 1, Census Tract 26, Multnomah County, Oregon",364,313,51,364,20,344,364,0,0,20,0,0,0,0,0,33,19,38,26,20,30,70,108,41,051,002600,1,410510026001
"Block Group 5, Census Tract 29.02, Multnomah County, Oregon",576,462,114,576,51,525,576,18,0,0,35,24,9,0,0,84,18,67,106,10,51,90,64,41,051,002902,5,410510029025
"Block Group 3, Census Tract 29.02, Multnomah County, Oregon",462,417,45,462,57,405,462,21,0,23,28,0,9,0,38,26,0,72,66,57,15,20,87,41,051,002902,3,410510029023
"Block Group 3, Census Tract 203.03, Clackamas County, Oregon",1148,829,319,1148,10,1138,1148,0,16,21,79,36,18,15,36,18,38,152,149,111,0,164,295,41,005,020303,3,410050203033
"Block Group 3, Census Tract 9709, Malheur County, Oregon",284,220,64,284,28,256,284,51,9,10,9,10,20,13,12,9,40,27,31,16,4,13,10,41,045,970900,3,410459709003
"Block Group 3, Census Tract 229.05, Clackamas County, Oregon",543,388,155,543,107,436,543,0,64,10,0,39,29,34,46,8,38,77,80,51,46,21,0,41,005,022905,3,410050229053
"Block Group 2, Census Tract 230.02, Clackamas County, Oregon",896,637,259,896,126,770,896,66,33,47,69,51,0,32,15,0,50,67,81,123,70,76,116,41,005,023002,2,410050230022
"Block Group 2, Census Tract 9601, Wheeler County, Oregon",380,212,168,380,49,331,380,16,31,45,29,15,25,23,30,21,30,54,27,15,7,10,2,41,069,960100,2,410699601002
"Block Group 3, Census Tract 312, Washington County, Oregon",1385,1061,324,1385,259,1126,1385,157,36,98,35,0,153,18,136,36,13,65,253,55,41,227,62,41,067,031200,3,410670312003
"Block Group 1, Census Tract 9400, Malheur County, Oregon",0,0,0,0,0,0,0,0,0,0,0,0,0,0,0,0,0,0,0,0,0,0,0,41,045,940000,1,410459400001
"Block Group 2, Census Tract 9709, Malheur County, Oregon",254,198,56,254,28,226,254,7,16,23,20,15,26,7,2,19,26,16,43,20,3,4,7,41,045,970900,2,410459709002
"Block Group 2, Census Tract 208.02, Linn County, Oregon",642,539,103,642,71,571,642,26,0,92,8,15,39,0,28,51,45,80,115,36,39,47,21,41,043,020802,2,410430208022
"Block Group 2, Census Tract 208.01, Linn County, Oregon",733,585,148,733,209,524,733,43,57,52,28,50,97,48,39,74,34,116,39,22,9,5,20,41,043,020801,2,410430208012
"Block Group 1, Census Tract 239.01, Clackamas County, Oregon",1890,1678,212,1890,154,1736,1890,87,39,78,39,61,14,12,131,40,174,135,419,389,110,145,17,41,005,023901,1,410050239011
"Block Group 3, Census Tract 11, Marion County, Oregon",700,479,221,700,122,578,700,77,48,46,9,44,31,26,44,36,81,31,85,84,14,44,0,41,047,001100,3,410470011003
"Block Group 4, Census Tract 20, Marion County, Oregon",1226,994,232,1226,169,1057,1226,0,26,58,49,168,118,132,80,30,117,160,92,16,83,76,21,41,047,002000,4,410470020004
"Block Group 3, Census Tract 203.04, Clackamas County, Oregon",938,825,113,938,14,924,938,0,27,14,14,86,98,16,25,0,43,60,177,36,59,156,127,41,005,020304,3,410050203043
"Block Group 3, Census Tract 22.02, Marion County, Oregon",1179,839,340,1179,193,986,1179,88,105,0,83,18,0,14,19,25,93,148,231,115,80,123,37,41,047,002202,3,410470022023
"Block Group 1, Census Tract 21.01, Marion County, Oregon",683,406,277,683,106,577,683,64,17,67,29,47,19,135,108,28,30,60,59,0,0,0,20,41,047,002101,1,410470021011
"Block Group 1, Census Tract 25.01, Marion County, Oregon",1382,1017,365,1382,99,1283,1382,16,10,0,0,36,80,34,96,15,96,127,269,305,124,97,77,41,047,002501,1,410470025011
"Block Group 3, Census Tract 23.04, Marion County, Oregon",1034,869,165,1034,224,810,1034,41,18,73,56,0,198,35,125,17,60,199,112,63,21,16,0,41,047,002304,3,410470023043
"Block Group 2, Census Tract 102.02, Marion County, Oregon",784,663,121,784,143,641,784,20,7,20,59,77,21,44,52,68,45,58,110,69,63,40,31,41,047,010202,2,410470102022
"Block Group 4, Census Tract 102.02, Marion County, Oregon",999,876,123,999,128,871,999,30,36,0,12,35,53,26,26,66,94,134,191,111,88,57,40,41,047,010202,4,410470102024
"Block Group 3, Census Tract 103.07, Marion County, Oregon",716,384,332,716,65,651,716,13,64,28,44,49,50,70,78,122,33,75,29,13,13,35,0,41,047,010307,3,410470103073
"Block Group 1, Census Tract 22.01, Marion County, Oregon",584,435,149,584,64,520,584,19,11,29,25,15,6,12,25,18,16,35,74,62,87,61,89,41,047,002201,1,410470022011
"Block Group 3, Census Tract 315.08, Washington County, Oregon",485,418,67,485,47,438,485,8,25,39,39,0,26,30,40,0,53,34,21,41,15,52,62,41,067,031508,3,410670315083
"Block Group 1, Census Tract 315.11, Washington County, Oregon",851,711,140,851,30,821,851,10,0,19,21,13,37,21,29,18,22,58,64,121,62,158,198,41,067,031511,1,410670315111
"Block Group 2, Census Tract 318.06, Washington County, Oregon",614,425,189,614,0,614,614,56,95,0,10,56,22,0,18,3,12,77,165,37,34,29,0,41,067,031806,2,410670318062
"Block Group 1, Census Tract 322, Washington County, Oregon",1670,1516,154,1670,40,1630,1670,26,13,9,0,23,43,55,17,0,116,170,136,400,186,201,275,41,067,032200,1,410670322001
"Block Group 1, Census Tract 332, Washington County, Oregon",300,243,57,300,101,199,300,0,0,38,49,0,24,13,43,0,13,46,63,11,0,0,0,41,067,033200,1,410670332001
"Block Group 2, Census Tract 210, Clackamas County, Oregon",1023,778,245,1023,107,916,1023,26,30,25,46,49,30,21,41,48,81,96,191,141,77,48,73,41,005,021000,2,410050210002
"Block Group 1, Census Tract 215, Clackamas County, Oregon",842,680,162,842,55,787,842,0,0,73,16,33,37,19,110,12,99,29,105,99,63,97,50,41,005,021500,1,410050215001
"Block Group 1, Census Tract 226.02, Clackamas County, Oregon",852,723,129,852,0,852,852,7,19,0,0,8,0,24,22,36,28,42,163,171,138,79,115,41,005,022602,1,410050226021
"Block Group 3, Census Tract 227.02, Clackamas County, Oregon",446,345,101,446,16,430,446,30,0,0,0,0,50,0,0,0,40,0,62,0,76,39,149,41,005,022702,3,410050227023
"Block Group 2, Census Tract 9510, Lincoln County, Oregon",560,410,150,560,222,338,560,73,35,27,34,98,22,12,41,10,79,46,34,33,0,0,16,41,041,951000,2,410419510002
"Block Group 1, Census Tract 9706, Klamath County, Oregon",593,506,87,593,79,514,593,15,11,7,43,95,31,39,21,3,47,32,93,68,30,49,9,41,035,970600,1,410359706001
"Block Group 3, Census Tract 9709, Klamath County, Oregon",490,276,214,490,258,232,490,0,122,109,22,70,0,25,0,21,7,28,59,0,17,0,10,41,035,970900,3,410359709003
"Block Group 2, Census Tract 9719, Klamath County, Oregon",329,288,41,329,83,246,329,34,45,15,7,27,32,42,42,0,21,21,43,0,0,0,0,41,035,971900,2,410359719002
"Block Group 2, Census Tract 9720, Klamath County, Oregon",453,354,99,453,10,443,453,18,10,8,10,0,17,54,13,10,24,56,104,19,50,41,19,41,035,972000,2,410359720002
"Block Group 3, Census Tract 9720, Klamath County, Oregon",629,434,195,629,67,562,629,0,36,18,58,0,42,27,0,25,41,40,62,57,47,106,70,41,035,972000,3,410359720003
"Block Group 3, Census Tract 2, Marion County, Oregon",580,358,222,580,131,449,580,85,48,32,78,18,30,0,39,4,20,34,87,40,8,26,31,41,047,000200,3,410470002003
"Block Group 1, Census Tract 3, Marion County, Oregon",522,413,109,522,105,417,522,66,35,17,9,16,38,68,16,10,17,80,34,61,34,21,0,41,047,000300,1,410470003001
"Block Group 1, Census Tract 12, Marion County, Oregon",805,630,175,805,151,654,805,14,77,67,19,25,27,18,96,11,63,116,69,71,60,42,30,41,047,001200,1,410470012001
"Block Group 2, Census Tract 25.02, Multnomah County, Oregon",539,510,29,539,58,481,539,14,25,42,0,29,17,0,33,15,41,80,111,56,20,14,42,41,051,002502,2,410510025022
"Block Group 1, Census Tract 25.02, Multnomah County, Oregon",248,181,67,248,11,237,248,0,0,32,0,0,11,0,0,0,14,0,14,73,27,0,77,41,051,002502,1,410510025021
"Block Group 2, Census Tract 27.01, Multnomah County, Oregon",494,429,65,494,0,494,494,0,9,12,23,0,0,16,0,0,14,7,74,34,51,97,157,41,051,002701,2,410510027012
"Block Group 4, Census Tract 37.01, Multnomah County, Oregon",307,255,52,307,66,241,307,0,0,52,0,0,10,0,14,0,12,11,46,53,45,21,43,41,051,003701,4,410510037014
"Block Group 1, Census Tract 39.02, Multnomah County, Oregon",256,232,24,256,34,222,256,9,0,0,13,0,0,0,30,0,20,5,40,9,36,36,58,41,051,003902,1,410510039021
"Block Group 1, Census Tract 48, Multnomah County, Oregon",730,655,75,730,54,676,730,81,0,0,40,53,30,12,14,29,58,67,95,115,71,14,51,41,051,004800,1,410510048001
"Block Group 1, Census Tract 49, Multnomah County, Oregon",1449,1188,261,1449,155,1294,1449,184,75,0,39,22,24,38,89,0,121,110,229,149,153,63,153,41,051,004900,1,410510049001
"Block Group 1, Census Tract 67.02, Multnomah County, Oregon",914,822,92,914,239,675,914,61,15,28,23,30,29,62,58,24,44,90,162,106,28,46,108,41,051,006702,1,410510067021
"Block Group 1, Census Tract 105, Multnomah County, Oregon",346,288,58,346,25,321,346,0,0,0,11,39,19,0,0,23,9,24,42,8,62,40,69,41,051,010500,1,410510105001
"Block Group 3, Census Tract 82.01, Multnomah County, Oregon",314,270,44,314,17,297,314,11,20,0,12,9,0,21,20,38,38,40,49,20,0,29,7,41,051,008201,3,410510082013
"Block Group 3, Census Tract 38.03, Multnomah County, Oregon",558,461,97,558,147,411,558,59,0,33,9,18,21,41,29,23,36,39,70,49,56,17,58,41,051,003803,3,410510038033
"Block Group 2, Census Tract 63, Multnomah County, Oregon",444,369,75,444,0,444,444,15,17,0,0,9,4,4,7,0,10,12,43,50,16,58,199,41,051,006300,2,410510063002
"Block Group 3, Census Tract 32, Multnomah County, Oregon",322,269,53,322,26,296,322,8,10,6,0,7,0,8,0,7,31,8,44,10,67,56,60,41,051,003200,3,410510032003
"Block Group 1, Census Tract 32, Multnomah County, Oregon",480,384,96,480,33,447,480,29,40,7,54,28,0,13,0,19,8,33,46,74,16,55,58,41,051,003200,1,410510032001
"Block Group 2, Census Tract 33.02, Multnomah County, Oregon",921,782,139,921,190,731,921,91,76,0,30,48,23,0,42,0,17,188,94,88,77,48,99,41,051,003302,2,410510033022
"Block Group 3, Census Tract 34.01, Multnomah County, Oregon",278,236,42,278,0,278,278,0,0,0,0,12,35,0,0,0,34,11,44,11,30,79,22,41,051,003401,3,410510034013
"Block Group 1, Census Tract 3.02, Multnomah County, Oregon",483,414,69,483,13,470,483,0,13,0,22,13,0,0,16,14,12,13,0,46,38,109,187,41,051,000302,1,410510003021
"Block Group 3, Census Tract 320.05, Washington County, Oregon",929,876,53,929,171,758,929,18,46,92,38,61,53,76,79,29,99,119,125,67,13,6,8,41,067,032005,3,410670320053
"Block Group 2, Census Tract 308.05, Washington County, Oregon",365,197,168,365,67,298,365,15,27,66,55,17,0,19,8,22,55,37,19,19,6,0,0,41,067,030805,2,410670308052
"Block Group 2, Census Tract 319.07, Washington County, Oregon",402,123,279,402,0,402,402,11,13,35,27,0,30,0,0,44,41,40,82,25,0,40,14,41,067,031907,2,410670319072
"Block Group 1, Census Tract 9, Deschutes County, Oregon",985,857,128,985,476,509,985,114,85,31,102,22,80,69,28,58,43,88,190,30,31,14,0,41,017,000900,1,410170009001
"Block Group 1, Census Tract 18, Deschutes County, Oregon",969,642,327,969,190,779,969,93,103,73,87,183,28,84,83,35,40,33,50,36,0,41,0,41,017,001800,1,410170018001
"Block Group 4, Census Tract 18, Deschutes County, Oregon",795,365,430,795,69,726,795,61,119,59,68,47,30,151,76,21,67,17,49,0,30,0,0,41,017,001800,4,410170018004
"Block Group 3, Census Tract 2, Deschutes County, Oregon",631,469,162,631,190,441,631,70,22,45,12,28,38,108,9,39,39,26,112,42,26,3,12,41,017,000200,3,410170002003
"Block Group 4, Census Tract 2, Deschutes County, Oregon",350,195,155,350,154,196,350,66,17,0,63,52,57,0,19,0,0,59,0,17,0,0,0,41,017,000200,4,410170002004
"Block Group 4, Census Tract 3, Deschutes County, Oregon",763,427,336,763,43,720,763,85,16,0,16,33,16,49,50,13,86,95,150,71,48,35,0,41,017,000300,4,410170003004
"Block Group 5, Census Tract 5, Deschutes County, Oregon",832,424,408,832,100,732,832,0,84,0,0,0,65,25,0,32,72,110,47,114,48,49,186,41,017,000500,5,410170005005
"Block Group 3, Census Tract 9504, Curry County, Oregon",866,505,361,866,122,744,866,13,17,38,35,9,145,0,47,15,102,163,143,30,17,48,44,41,015,950400,3,410159504003
"Block Group 2, Census Tract 9504, Curry County, Oregon",616,34,582,616,127,489,616,65,0,130,49,103,84,60,16,75,34,0,0,0,0,0,0,41,015,950400,2,410159504002
"Block Group 2, Census Tract 96.03, Multnomah County, Oregon",652,502,150,652,188,464,652,25,78,99,15,24,44,85,18,16,19,101,78,15,20,15,0,41,051,009603,2,410510096032
"Block Group 3, Census Tract 9708, Union County, Oregon",457,329,128,457,143,314,457,61,51,26,33,19,43,0,30,20,23,35,47,22,0,28,19,41,061,970800,3,410619708003
"Block Group 2, Census Tract 9708, Union County, Oregon",370,291,79,370,118,252,370,48,27,8,45,37,52,9,10,0,0,56,18,9,6,35,10,41,061,970800,2,410619708002
"Block Group 5, Census Tract 203, Linn County, Oregon",1315,1087,228,1315,64,1251,1315,13,10,9,0,8,8,11,46,49,61,288,243,141,169,163,96,41,043,020300,5,410430203005
"Block Group 3, Census Tract 203, Linn County, Oregon",493,422,71,493,64,429,493,39,50,0,0,10,14,84,97,0,0,82,57,0,60,0,0,41,043,020300,3,410430203003
"Block Group 3, Census Tract 204, Linn County, Oregon",594,481,113,594,200,394,594,63,55,45,68,54,51,31,26,0,49,41,49,29,0,33,0,41,043,020400,3,410430204003
"Block Group 3, Census Tract 305, Linn County, Oregon",557,486,71,557,47,510,557,10,11,0,4,20,31,37,42,34,41,75,89,56,0,52,55,41,043,030500,3,410430305003
"Block Group 4, Census Tract 16.02, Jackson County, Oregon",393,325,68,393,0,393,393,10,23,14,16,0,0,13,0,30,15,13,0,67,16,144,32,41,029,001602,4,410290016024
"Block Group 2, Census Tract 16.02, Jackson County, Oregon",815,564,251,815,262,553,815,68,103,31,150,144,34,17,21,52,37,58,35,15,36,0,14,41,029,001602,2,410290016022
"Block Group 2, Census Tract 16.01, Jackson County, Oregon",622,251,371,622,132,490,622,134,41,22,45,78,22,21,77,32,32,78,29,11,0,0,0,41,029,001601,2,410290016012
"Block Group 1, Census Tract 4.03, Jackson County, Oregon",1324,866,458,1324,128,1196,1324,94,26,54,24,21,6,104,136,36,79,168,175,124,127,68,82,41,029,000403,1,410290004031
"Block Group 2, Census Tract 316.14, Washington County, Oregon",1084,1004,80,1084,166,918,1084,39,37,22,41,39,35,28,17,16,120,154,113,149,105,93,76,41,067,031614,2,410670316142
"Block Group 2, Census Tract 324.07, Washington County, Oregon",1031,946,85,1031,89,942,1031,25,10,28,13,31,9,0,26,24,22,66,112,288,80,141,156,41,067,032407,2,410670324072
"Block Group 1, Census Tract 321.08, Washington County, Oregon",510,451,59,510,10,500,510,0,0,0,26,11,0,11,0,12,19,10,81,67,107,89,77,41,067,032108,1,410670321081
"Block Group 1, Census Tract 9800, Multnomah County, Oregon",0,0,0,0,0,0,0,0,0,0,0,0,0,0,0,0,0,0,0,0,0,0,0,41,051,980000,1,410519800001
"Block Group 1, Census Tract 9400, Umatilla County, Oregon",356,278,78,356,32,324,356,10,8,8,15,19,6,16,7,11,27,39,48,34,66,26,16,41,059,940000,1,410599400001
"Block Group 1, Census Tract 222.07, Clackamas County, Oregon",1458,1326,132,1458,57,1401,1458,9,23,11,0,7,16,31,29,11,39,146,166,253,173,285,259,41,005,022207,1,410050222071
"Block Group 3, Census Tract 223.01, Clackamas County, Oregon",401,306,95,401,142,259,401,78,21,0,15,0,0,52,16,10,23,29,44,51,19,36,7,41,005,022301,3,410050223013
"Block Group 1, Census Tract 223.02, Clackamas County, Oregon",637,570,67,637,22,615,637,0,0,0,0,17,0,0,25,15,18,60,116,36,73,135,142,41,005,022302,1,410050223021
"Block Group 1, Census Tract 226.06, Clackamas County, Oregon",1872,1577,295,1872,90,1782,1872,21,42,0,32,30,47,18,47,48,72,239,407,199,304,231,135,41,005,022606,1,410050226061
"Block Group 2, Census Tract 226.05, Clackamas County, Oregon",1030,680,350,1030,120,910,1030,33,0,51,17,12,11,16,65,96,66,251,86,103,64,141,18,41,005,022605,2,410050226052
"Block Group 2, Census Tract 1, Benton County, Oregon",735,576,159,735,210,525,735,79,38,65,86,29,111,17,79,41,79,0,80,0,0,0,31,41,003,000100,2,410030001002
"Block Group 1, Census Tract 6, Benton County, Oregon",921,714,207,921,306,615,921,166,17,238,103,43,38,0,34,42,43,96,85,0,0,16,0,41,003,000600,1,410030006001
"Block Group 2, Census Tract 47, Lane County, Oregon",322,249,73,322,53,269,322,33,0,10,0,7,14,7,0,18,19,61,37,28,9,18,61,41,039,004700,2,410390047002
"Block Group 4, Census Tract 50, Lane County, Oregon",571,409,162,571,36,535,571,0,24,14,35,45,34,14,31,0,0,45,84,36,45,62,102,41,039,005000,4,410390050004
"Block Group 2, Census Tract 50, Lane County, Oregon",701,535,166,701,126,575,701,34,23,29,17,70,36,46,20,38,20,51,217,49,30,21,0,41,039,005000,2,410390050002
"Block Group 3, Census Tract 44.03, Lane County, Oregon",346,235,111,346,154,192,346,93,0,26,57,7,0,0,53,29,0,15,0,0,66,0,0,41,039,004403,3,410390044033
"Block Group 2, Census Tract 48, Lane County, Oregon",472,418,54,472,71,401,472,25,36,12,11,23,17,26,0,15,14,132,107,35,0,0,19,41,039,004800,2,410390048002
"Block Group 2, Census Tract 9.03, Lane County, Oregon",648,526,122,648,75,573,648,38,15,0,31,14,17,62,0,65,103,155,62,59,27,0,0,41,039,000903,2,410390009032
"Block Group 3, Census Tract 13.02, Lane County, Oregon",622,527,95,622,147,475,622,38,48,22,0,28,49,54,19,18,100,50,58,25,47,56,10,41,039,001302,3,410390013023
"Block Group 1, Census Tract 13.02, Lane County, Oregon",581,336,245,581,94,487,581,74,41,43,9,27,16,37,0,53,39,93,54,31,38,0,26,41,039,001302,1,410390013021
"Block Group 5, Census Tract 16, Lane County, Oregon",458,405,53,458,158,300,458,31,0,19,0,18,13,15,41,23,67,99,42,24,21,0,45,41,039,001600,5,410390016005
"Block Group 2, Census Tract 21.01, Lane County, Oregon",639,380,259,639,244,395,639,99,40,27,61,15,106,31,43,34,38,44,64,11,26,0,0,41,039,002101,2,410390021012
"Block Group 1, Census Tract 334, Washington County, Oregon",367,287,80,367,13,354,367,11,0,0,6,39,0,0,6,6,13,60,19,56,56,32,63,41,067,033400,1,410670334001
"Block Group 1, Census Tract 302, Washington County, Oregon",662,495,167,662,14,648,662,27,17,0,16,56,0,86,0,40,44,81,97,31,0,70,97,41,067,030200,1,410670302001
"Block Group 2, Census Tract 308.01, Washington County, Oregon",570,467,103,570,55,515,570,0,0,0,0,16,0,0,0,0,85,59,116,87,72,52,83,41,067,030801,2,410670308012
"Block Group 1, Census Tract 316.11, Washington County, Oregon",1056,814,242,1056,9,1047,1056,33,0,0,0,27,10,49,32,13,133,97,247,46,106,88,175,41,067,031611,1,410670316111
"Block Group 1, Census Tract 17.01, Multnomah County, Oregon",235,216,19,235,0,235,235,0,0,0,19,29,0,0,0,33,33,0,47,33,41,0,0,41,051,001701,1,410510017011
"Block Group 2, Census Tract 9706, Columbia County, Oregon",292,232,60,292,35,257,292,0,0,0,46,0,24,0,29,13,14,9,81,55,9,0,12,41,009,970600,2,410099706002
"Block Group 4, Census Tract 9706, Columbia County, Oregon",671,498,173,671,34,637,671,27,0,16,0,30,12,30,23,15,51,105,58,95,27,111,71,41,009,970600,4,410099706004
"Block Group 3, Census Tract 9709, Columbia County, Oregon",1169,735,434,1169,125,1044,1169,36,50,82,37,81,27,33,51,31,140,67,184,163,103,29,55,41,009,970900,3,410099709003
"Block Group 1, Census Tract 9512, Lincoln County, Oregon",584,373,211,584,82,502,584,50,18,22,6,12,61,20,31,38,78,78,85,45,14,11,15,41,041,951200,1,410419512001
"Block Group 1, Census Tract 101, Marion County, Oregon",272,215,57,272,10,262,272,1,13,11,8,2,7,11,5,6,27,16,49,40,23,38,15,41,047,010100,1,410470101001
"Block Group 1, Census Tract 221.03, Clackamas County, Oregon",1316,1036,280,1316,141,1175,1316,41,0,19,89,30,30,52,12,20,151,151,175,136,139,88,183,41,005,022103,1,410050221031
"Block Group 1, Census Tract 229.01, Clackamas County, Oregon",1382,1124,258,1382,67,1315,1382,7,8,65,22,30,9,29,0,25,132,196,201,141,209,173,135,41,005,022901,1,410050229011
"Block Group 4, Census Tract 235, Clackamas County, Oregon",219,82,137,219,56,163,219,0,0,0,0,42,0,0,15,41,72,19,0,14,16,0,0,41,005,023500,4,410050235004
"Block Group 4, Census Tract 238, Clackamas County, Oregon",887,732,155,887,103,784,887,21,0,0,61,0,29,52,0,0,125,91,152,146,29,124,57,41,005,023800,4,410050238004
"Block Group 2, Census Tract 49, Lane County, Oregon",744,651,93,744,55,689,744,82,45,7,77,103,52,24,23,43,53,50,36,42,35,51,21,41,039,004900,2,410390049002
"Block Group 2, Census Tract 3, Lane County, Oregon",452,305,147,452,88,364,452,14,13,22,19,42,25,25,21,48,28,38,63,55,15,16,8,41,039,000300,2,410390003002
"Block Group 2, Census Tract 11.01, Lane County, Oregon",621,539,82,621,155,466,621,0,0,20,52,0,30,160,0,0,45,85,132,57,24,16,0,41,039,001101,2,410390011012
"Block Group 2, Census Tract 11.02, Lane County, Oregon",654,521,133,654,187,467,654,44,66,21,35,7,102,29,35,14,31,17,162,59,22,0,10,41,039,001102,2,410390011022
"Block Group 1, Census Tract 14, Lane County, Oregon",630,410,220,630,85,545,630,59,23,10,41,6,44,18,41,34,35,48,155,34,17,42,23,41,039,001400,1,410390014001
"Block Group 2, Census Tract 17, Lane County, Oregon",321,204,117,321,73,248,321,15,50,0,16,54,0,0,0,0,16,74,30,42,0,0,24,41,039,001700,2,410390017002
"Block Group 2, Census Tract 24.01, Lane County, Oregon",647,504,143,647,19,628,647,0,38,0,0,29,9,0,51,31,7,59,83,111,45,107,77,41,039,002401,2,410390024012
"Block Group 2, Census Tract 500.02, Douglas County, Oregon",407,355,52,407,119,288,407,21,0,0,46,12,0,55,20,54,16,47,104,32,0,0,0,41,019,050002,2,410190500022
"Block Group 1, Census Tract 1000, Douglas County, Oregon",411,312,99,411,90,321,411,19,10,29,34,24,46,0,0,58,23,31,54,83,0,0,0,41,019,100000,1,410191000001
"Block Group 3, Census Tract 1200, Douglas County, Oregon",500,420,80,500,132,368,500,35,18,33,14,17,30,75,29,0,52,103,94,0,0,0,0,41,019,120000,3,410191200003
"Block Group 6, Census Tract 1200, Douglas County, Oregon",287,242,45,287,33,254,287,14,0,0,0,31,16,20,0,32,22,40,51,19,42,0,0,41,019,120000,6,410191200006
"Block Group 4, Census Tract 900, Douglas County, Oregon",638,483,155,638,210,428,638,57,17,0,15,83,28,54,32,36,136,38,66,37,39,0,0,41,019,090000,4,410190900004
"Block Group 3, Census Tract 900, Douglas County, Oregon",1341,881,460,1341,289,1052,1341,43,188,74,60,0,74,40,0,60,170,92,268,175,15,46,36,41,019,090000,3,410190900003
"Block Group 1, Census Tract 309.02, Linn County, Oregon",378,286,92,378,15,363,378,0,0,15,0,0,0,16,55,68,19,18,79,71,37,0,0,41,043,030902,1,410430309021
"Block Group 4, Census Tract 309.03, Linn County, Oregon",675,520,155,675,72,603,675,38,0,36,0,53,0,67,0,28,36,105,138,57,33,0,84,41,043,030903,4,410430309034
"Block Group 2, Census Tract 309.03, Linn County, Oregon",441,263,178,441,205,236,441,46,56,31,89,14,63,0,15,0,18,0,78,0,0,31,0,41,043,030903,2,410430309032
"Block Group 2, Census Tract 309.04, Linn County, Oregon",744,503,241,744,259,485,744,127,82,56,31,34,37,50,16,21,69,52,85,65,14,5,0,41,043,030904,2,410430309042
"Block Group 2, Census Tract 201, Linn County, Oregon",788,634,154,788,220,568,788,29,0,13,17,21,86,35,34,0,63,97,222,53,118,0,0,41,043,020100,2,410430201002
"Block Group 1, Census Tract 206, Linn County, Oregon",1264,945,319,1264,307,957,1264,78,91,112,70,40,71,16,42,124,82,107,233,109,11,0,78,41,043,020600,1,410430206001
"Block Group 5, Census Tract 206, Linn County, Oregon",423,284,139,423,43,380,423,0,0,18,6,48,60,10,0,67,60,26,37,42,36,0,13,41,043,020600,5,410430206005
"Block Group 4, Census Tract 304.02, Linn County, Oregon",506,321,185,506,186,320,506,34,52,31,15,46,39,55,0,0,40,33,94,27,28,12,0,41,043,030402,4,410430304024
"Block Group 3, Census Tract 304.02, Linn County, Oregon",495,342,153,495,121,374,495,26,0,44,40,29,54,35,0,57,36,75,26,45,0,15,13,41,043,030402,3,410430304023
"Block Group 3, Census Tract 308, Linn County, Oregon",686,563,123,686,164,522,686,10,26,13,83,0,58,45,0,86,91,80,140,43,0,11,0,41,043,030800,3,410430308003
"Block Group 4, Census Tract 1300, Douglas County, Oregon",678,463,215,678,85,593,678,0,14,27,66,0,130,29,19,41,77,112,47,68,0,14,34,41,019,130000,4,410191300004
"Block Group 3, Census Tract 9, Coos County, Oregon",426,188,238,426,216,210,426,41,0,87,49,14,84,51,14,19,17,23,15,0,12,0,0,41,011,000900,3,410110009003
"Block Group 5, Census Tract 9, Coos County, Oregon",261,99,162,261,53,208,261,46,51,54,27,0,0,0,0,15,13,29,26,0,0,0,0,41,011,000900,5,410110009005
"Block Group 1, Census Tract 9501, Curry County, Oregon",451,252,199,451,93,358,451,13,21,39,27,23,75,17,0,26,57,94,9,45,0,0,5,41,015,950100,1,410159501001
"Block Group 3, Census Tract 310.05, Washington County, Oregon",563,514,49,563,256,307,563,0,16,25,35,17,25,15,0,73,85,98,53,102,0,19,0,41,067,031005,3,410670310053
"Block Group 1, Census Tract 9515, Lincoln County, Oregon",457,323,134,457,136,321,457,68,36,10,58,25,10,22,22,0,27,2,56,11,73,0,37,41,041,951500,1,410419515001
"Block Group 1, Census Tract 9513, Lincoln County, Oregon",487,313,174,487,73,414,487,26,21,0,0,17,56,71,10,24,0,32,46,55,24,46,59,41,041,951300,1,410419513001
"Block Group 3, Census Tract 5, Benton County, Oregon",410,308,102,410,82,328,410,90,30,0,19,0,10,0,9,10,20,33,33,51,16,17,72,41,003,000500,3,410030005003
"Block Group 2, Census Tract 9, Benton County, Oregon",269,174,95,269,4,265,269,61,0,12,0,32,16,0,9,14,13,12,33,19,0,13,35,41,003,000900,2,410030009002
"Block Group 1, Census Tract 9, Benton County, Oregon",325,212,113,325,0,325,325,18,14,15,12,13,11,0,0,0,12,42,16,42,0,82,48,41,003,000900,1,410030009001
"Block Group 2, Census Tract 10.02, Benton County, Oregon",618,513,105,618,74,544,618,24,17,79,45,39,36,36,15,15,59,54,83,37,24,33,22,41,003,001002,2,410030010022
"Block Group 2, Census Tract 25.01, Lane County, Oregon",754,665,89,754,140,614,754,18,22,17,15,34,8,68,37,48,32,130,113,164,29,19,0,41,039,002501,2,410390025012
"Block Group 2, Census Tract 238, Clackamas County, Oregon",382,233,149,382,56,326,382,0,42,14,0,0,67,15,0,0,36,57,74,33,30,0,14,41,005,023800,2,410050238002
"Block Group 1, Census Tract 216.01, Clackamas County, Oregon",374,301,73,374,26,348,374,0,0,0,0,17,31,12,31,0,0,70,89,82,24,18,0,41,005,021601,1,410050216011
"Block Group 2, Census Tract 9701, Klamath County, Oregon",870,468,402,870,136,734,870,43,87,17,13,39,21,85,33,76,138,127,91,51,32,12,5,41,035,970100,2,410359701002
"Block Group 1, Census Tract 30.02, Jackson County, Oregon",571,362,209,571,49,522,571,46,14,36,59,12,31,42,0,0,73,17,11,102,88,23,17,41,029,003002,1,410290030021
"Block Group 3, Census Tract 25, Jackson County, Oregon",208,183,25,208,0,208,208,0,16,7,19,8,0,0,9,12,0,20,35,7,0,44,31,41,029,002500,3,410290025003
"Block Group 3, Census Tract 9, Jackson County, Oregon",291,166,125,291,26,265,291,0,13,0,0,12,0,0,60,0,28,0,50,0,13,66,49,41,029,000900,3,410290009003
"Block Group 2, Census Tract 14, Jackson County, Oregon",902,661,241,902,55,847,902,0,76,0,0,0,125,83,22,0,129,184,37,101,48,0,97,41,029,001400,2,410290014002
"Block Group 1, Census Tract 23, Jackson County, Oregon",262,158,104,262,41,221,262,12,5,22,7,10,14,9,4,8,18,49,33,18,16,20,17,41,029,002300,1,410290023001
"Block Group 2, Census Tract 2.01, Jackson County, Oregon",500,455,45,500,232,268,500,135,28,15,23,0,40,9,63,28,67,0,48,27,9,0,8,41,029,000201,2,410290002012
"Block Group 3, Census Tract 15, Jackson County, Oregon",261,114,147,261,50,211,261,37,0,0,0,13,48,14,0,0,48,27,13,17,13,15,16,41,029,001500,3,410290015003
"Block Group 1, Census Tract 2000, Douglas County, Oregon",454,289,165,454,95,359,454,35,27,30,27,15,12,6,18,4,70,90,36,35,19,26,4,41,019,200000,1,410192000001
"Block Group 3, Census Tract 9602, Grant County, Oregon",698,416,282,698,104,594,698,57,38,13,63,28,42,98,36,34,84,44,116,16,14,13,2,41,023,960200,3,410239602003
"Block Group 1, Census Tract 9602, Grant County, Oregon",353,240,113,353,15,338,353,16,11,23,18,6,16,15,12,28,41,59,41,32,28,1,6,41,023,960200,1,410239602001
"Block Group 1, Census Tract 308, Linn County, Oregon",345,273,72,345,52,293,345,14,11,16,53,10,0,0,12,13,33,39,12,57,9,33,33,41,043,030800,1,410430308001
"Block Group 5, Census Tract 308, Linn County, Oregon",673,481,192,673,142,531,673,25,22,64,75,0,10,23,59,55,65,56,52,75,29,53,10,41,043,030800,5,410430308005
"Block Group 2, Census Tract 301, Linn County, Oregon",517,404,113,517,32,485,517,18,14,0,0,91,17,0,0,54,53,16,38,89,77,50,0,41,043,030100,2,410430301002
"Block Group 1, Census Tract 9608, Tillamook County, Oregon",411,210,201,411,111,300,411,86,33,41,52,0,7,10,22,29,10,9,81,31,0,0,0,41,057,960800,1,410579608001
"Block Group 1, Census Tract 9606, Tillamook County, Oregon",172,120,52,172,43,129,172,0,16,11,32,25,0,0,0,0,27,34,27,0,0,0,0,41,057,960600,1,410579606001
"Block Group 2, Census Tract 9606, Tillamook County, Oregon",429,302,127,429,28,401,429,0,18,19,0,10,0,78,19,9,17,86,110,9,14,40,0,41,057,960600,2,410579606002
"Block Group 1, Census Tract 9601, Tillamook County, Oregon",553,312,241,553,69,484,553,7,4,46,25,25,32,31,10,53,92,86,69,49,0,21,3,41,057,960100,1,410579601001
"Block Group 2, Census Tract 9604, Tillamook County, Oregon",650,470,180,650,282,368,650,97,44,0,85,93,50,0,38,56,43,0,93,32,0,19,0,41,057,960400,2,410579604002
"Block Group 2, Census Tract 13.01, Lane County, Oregon",604,351,253,604,172,432,604,37,22,91,41,36,66,10,9,47,68,82,95,0,0,0,0,41,039,001301,2,410390013012
"Block Group 1, Census Tract 18.03, Lane County, Oregon",519,374,145,519,116,403,519,17,49,17,7,30,45,8,34,20,46,75,58,36,46,10,21,41,039,001803,1,410390018031
"Block Group 2, Census Tract 19.04, Lane County, Oregon",929,729,200,929,134,795,929,49,0,28,125,46,80,30,58,93,53,153,111,64,0,39,0,41,039,001904,2,410390019042
"Block Group 1, Census Tract 20.01, Lane County, Oregon",798,545,253,798,174,624,798,43,93,25,64,36,57,43,53,22,32,60,69,78,31,43,49,41,039,002001,1,410390020011
"Block Group 2, Census Tract 5, Deschutes County, Oregon",169,42,127,169,0,169,169,0,0,0,0,0,0,47,0,0,0,105,0,0,17,0,0,41,017,000500,2,410170005002
"Block Group 3, Census Tract 7.05, Lane County, Oregon",596,446,150,596,169,427,596,0,35,42,51,58,59,24,138,0,70,62,13,18,12,14,0,41,039,000705,3,410390007053
"Block Group 2, Census Tract 25.03, Lane County, Oregon",768,466,302,768,49,719,768,22,64,39,26,47,99,62,33,36,78,62,95,39,27,39,0,41,039,002503,2,410390025032
"Block Group 2, Census Tract 44.04, Lane County, Oregon",410,307,103,410,28,382,410,0,11,7,19,40,7,49,6,18,10,8,92,73,13,38,19,41,039,004404,2,410390044042
"Block Group 1, Census Tract 9603.02, Jefferson County, Oregon",240,156,84,240,8,232,240,0,4,0,8,13,10,15,12,12,43,12,32,23,22,24,10,41,031,960302,1,410319603021
"Block Group 2, Census Tract 9502, Curry County, Oregon",801,508,293,801,146,655,801,52,46,40,25,43,106,40,36,14,96,97,73,65,13,55,0,41,015,950200,2,410159502002
"Block Group 3, Census Tract 9503.01, Curry County, Oregon",607,382,225,607,62,545,607,33,41,0,82,77,12,17,0,10,41,111,73,73,37,0,0,41,015,950301,3,410159503013
"Block Group 2, Census Tract 12.01, Lane County, Oregon",445,304,141,445,72,373,445,30,19,9,8,44,23,21,9,15,63,75,46,49,27,0,7,41,039,001201,2,410390012012
"Block Group 3, Census Tract 31.02, Lane County, Oregon",1269,817,452,1269,245,1024,1269,267,99,115,168,108,70,90,51,99,92,30,51,29,0,0,0,41,039,003102,3,410390031023
"Block Group 1, Census Tract 27, Lane County, Oregon",874,729,145,874,228,646,874,16,50,37,41,47,49,22,47,19,106,153,133,113,27,0,14,41,039,002700,1,410390027001
"Block Group 1, Census Tract 32.01, Lane County, Oregon",274,185,89,274,150,124,274,7,0,25,0,60,19,37,22,26,10,55,0,13,0,0,0,41,039,003201,1,410390032011
"Block Group 1, Census Tract 12.02, Lane County, Oregon",684,459,225,684,82,602,684,27,24,22,25,44,26,30,65,21,68,54,131,42,39,25,41,41,039,001202,1,410390012021
"Block Group 3, Census Tract 15, Lane County, Oregon",325,198,127,325,66,259,325,44,35,26,19,0,13,0,25,14,0,58,26,65,0,0,0,41,039,001500,3,410390015003
"Block Group 2, Census Tract 18.01, Lane County, Oregon",778,673,105,778,192,586,778,18,17,35,19,73,12,10,64,7,29,48,246,114,32,9,45,41,039,001801,2,410390018012
"Block Group 3, Census Tract 54, Lane County, Oregon",846,576,270,846,28,818,846,0,14,64,10,62,34,46,14,15,15,79,79,88,82,154,90,41,039,005400,3,410390054003
"Block Group 4, Census Tract 54, Lane County, Oregon",383,308,75,383,15,368,383,0,0,28,16,0,0,16,0,37,14,91,18,94,35,19,15,41,039,005400,4,410390054004
"Block Group 3, Census Tract 43, Lane County, Oregon",445,340,105,445,114,331,445,18,35,0,0,53,52,123,0,13,0,98,39,14,0,0,0,41,039,004300,3,410390043003
"Block Group 1, Census Tract 38.01, Multnomah County, Oregon",560,444,116,560,52,508,560,24,10,53,8,18,17,58,0,18,75,59,79,62,55,16,8,41,051,003801,1,410510038011
"Block Group 1, Census Tract 2, Lane County, Oregon",609,420,189,609,99,510,609,0,0,30,11,0,9,13,16,62,0,71,99,61,56,86,95,41,039,000200,1,410390002001
"Block Group 3, Census Tract 2, Lane County, Oregon",307,209,98,307,35,272,307,6,0,11,28,10,9,3,8,2,16,36,80,22,17,43,16,41,039,000200,3,410390002003
"Block Group 2, Census Tract 26, Lane County, Oregon",558,358,200,558,102,456,558,6,35,19,90,47,50,52,30,0,0,60,102,51,16,0,0,41,039,002600,2,410390026002
"Block Group 2, Census Tract 4.03, Lane County, Oregon",590,485,105,590,90,500,590,12,44,76,0,20,15,23,11,0,46,63,106,104,17,37,16,41,039,000403,2,410390004032
"Block Group 2, Census Tract 9.04, Lane County, Oregon",904,663,241,904,233,671,904,30,142,9,40,99,29,85,56,44,27,71,117,105,0,50,0,41,039,000904,2,410390009042
"Block Group 1, Census Tract 20.02, Lane County, Oregon",987,697,290,987,84,903,987,30,14,16,31,25,68,15,16,12,67,128,260,170,39,60,36,41,039,002002,1,410390020021
"Block Group 1, Census Tract 24.03, Lane County, Oregon",797,556,241,797,96,701,797,6,22,15,50,41,23,11,10,19,102,108,129,84,64,68,45,41,039,002403,1,410390024031
"Block Group 1, Census Tract 73, Multnomah County, Oregon",186,138,48,186,38,148,186,11,26,0,6,6,5,21,0,20,6,12,50,17,0,6,0,41,051,007300,1,410510073001
"Block Group 3, Census Tract 89.01, Multnomah County, Oregon",602,491,111,602,18,584,602,35,0,0,18,20,0,0,35,23,57,50,99,84,56,82,43,41,051,008901,3,410510089013
"Block Group 3, Census Tract 90, Multnomah County, Oregon",1247,979,268,1247,588,659,1247,115,62,188,125,47,102,38,35,75,0,83,176,85,0,20,96,41,051,009000,3,410510090003
"Block Group 1, Census Tract 92.02, Multnomah County, Oregon",796,612,184,796,282,514,796,67,43,54,51,68,86,64,29,5,75,71,52,55,19,25,32,41,051,009202,1,410510092021
"Block Group 4, Census Tract 52.02, Polk County, Oregon",1210,857,353,1210,50,1160,1210,43,18,0,15,65,86,77,35,56,129,129,125,250,108,58,16,41,053,005202,4,410530052024
"Block Group 1, Census Tract 52.02, Polk County, Oregon",701,375,326,701,79,622,701,14,83,118,14,49,93,49,0,0,15,79,101,35,19,17,15,41,053,005202,1,410530052021
"Block Group 1, Census Tract 53, Polk County, Oregon",410,326,84,410,19,391,410,18,0,19,0,0,70,0,19,30,15,36,67,19,40,0,77,41,053,005300,1,410530053001
"Block Group 6, Census Tract 9604, Tillamook County, Oregon",283,147,136,283,46,237,283,0,10,0,28,0,0,59,10,0,0,25,101,15,18,0,17,41,057,960400,6,410579604006
"Block Group 2, Census Tract 9605, Tillamook County, Oregon",346,202,144,346,131,215,346,64,9,61,0,17,12,0,22,29,17,39,52,15,9,0,0,41,057,960500,2,410579605002
"Block Group 1, Census Tract 9607, Tillamook County, Oregon",436,264,172,436,118,318,436,0,27,27,22,39,22,43,62,0,21,53,57,41,5,17,0,41,057,960700,1,410579607001
"Block Group 2, Census Tract 305.01, Yamhill County, Oregon",296,217,79,296,55,241,296,54,9,17,9,0,15,29,0,11,18,23,33,40,18,11,9,41,071,030501,2,410710305012
"Block Group 2, Census Tract 307.02, Yamhill County, Oregon",287,218,69,287,123,164,287,87,0,21,0,67,0,16,18,11,18,15,18,16,0,0,0,41,071,030702,2,410710307022
"Block Group 2, Census Tract 310, Yamhill County, Oregon",751,590,161,751,179,572,751,70,20,25,63,13,30,35,21,12,49,85,116,50,84,68,10,41,071,031000,2,410710310002
"Block Group 1, Census Tract 302.01, Yamhill County, Oregon",517,449,68,517,98,419,517,18,30,48,37,34,34,19,28,0,32,20,96,35,41,45,0,41,071,030201,1,410710302011
"Block Group 1, Census Tract 105.03, Marion County, Oregon",363,284,79,363,93,270,363,7,25,19,23,41,0,12,21,10,33,29,95,0,10,24,14,41,047,010503,1,410470105031
"Block Group 3, Census Tract 107.01, Marion County, Oregon",257,201,56,257,103,154,257,14,15,26,0,0,0,0,34,0,15,0,153,0,0,0,0,41,047,010701,3,410470107013
"Block Group 2, Census Tract 202.02, Polk County, Oregon",964,594,370,964,61,903,964,31,35,29,0,86,30,0,35,82,81,193,127,89,75,44,27,41,053,020202,2,410530202022
"Block Group 2, Census Tract 52.01, Polk County, Oregon",1891,1532,359,1891,57,1834,1891,59,33,32,26,53,131,20,58,43,107,241,446,176,106,186,174,41,053,005201,2,410530052012
"Block Group 2, Census Tract 29.02, Lane County, Oregon",615,484,131,615,68,547,615,26,12,8,12,27,41,67,8,33,80,58,105,72,20,21,25,41,039,002902,2,410390029022
"Block Group 3, Census Tract 30, Lane County, Oregon",581,394,187,581,59,522,581,34,15,52,0,8,14,9,26,0,48,54,88,43,73,83,34,41,039,003000,3,410390030003
"Block Group 2, Census Tract 1600, Douglas County, Oregon",969,677,292,969,253,716,969,79,26,135,101,47,89,42,61,30,73,13,127,43,45,41,17,41,019,160000,2,410191600002
"Block Group 2, Census Tract 1900, Douglas County, Oregon",536,365,171,536,127,409,536,12,7,34,3,53,118,10,35,10,46,86,104,18,0,0,0,41,019,190000,2,410191900002
"Block Group 2, Census Tract 200, Douglas County, Oregon",411,263,148,411,76,335,411,8,19,24,30,44,7,69,16,25,25,25,53,57,0,9,0,41,019,020000,2,410190200002
"Block Group 1, Census Tract 200, Douglas County, Oregon",223,171,52,223,9,214,223,0,8,42,33,0,9,30,17,0,8,8,9,50,9,0,0,41,019,020000,1,410190200001
"Block Group 2, Census Tract 1100, Douglas County, Oregon",444,273,171,444,39,405,444,10,31,23,18,5,4,24,54,25,12,34,87,38,29,30,20,41,019,110000,2,410191100002
"Block Group 3, Census Tract 1500, Douglas County, Oregon",617,442,175,617,159,458,617,0,0,20,67,9,39,40,23,35,86,68,103,94,16,17,0,41,019,150000,3,410191500003
"Block Group 3, Census Tract 302, Linn County, Oregon",239,145,94,239,37,202,239,2,22,22,33,0,0,0,1,10,0,27,65,32,24,1,0,41,043,030200,3,410430302003
"Block Group 1, Census Tract 302, Linn County, Oregon",432,251,181,432,96,336,432,17,37,32,2,24,43,0,0,4,143,80,21,14,12,3,0,41,043,030200,1,410430302001
"Block Group 4, Census Tract 302, Linn County, Oregon",417,308,109,417,41,376,417,0,14,35,15,0,0,0,77,0,74,67,51,58,0,13,13,41,043,030200,4,410430302004
"Block Group 2, Census Tract 303, Linn County, Oregon",340,272,68,340,36,304,340,11,0,0,43,20,11,4,30,0,37,34,44,8,50,8,40,41,043,030300,2,410430303002
"Block Group 3, Census Tract 304.01, Linn County, Oregon",472,250,222,472,72,400,472,16,23,46,43,15,38,39,0,52,17,52,26,77,0,28,0,41,043,030401,3,410430304013
"Block Group 1, Census Tract 17, Jackson County, Oregon",652,436,216,652,20,632,652,83,28,28,30,0,60,23,139,24,62,64,48,48,15,0,0,41,029,001700,1,410290017001
"Block Group 1, Census Tract 19, Jackson County, Oregon",710,648,62,710,137,573,710,67,55,36,66,89,38,47,48,11,108,42,28,12,18,34,11,41,029,001900,1,410290019001
"Block Group 2, Census Tract 1, Jackson County, Oregon",432,233,199,432,271,161,432,122,51,35,31,49,29,41,6,4,21,33,0,10,0,0,0,41,029,000100,2,410290001002
"Block Group 2, Census Tract 224, Clackamas County, Oregon",398,370,28,398,45,353,398,0,0,10,0,20,7,52,26,43,51,39,49,53,21,27,0,41,005,022400,2,410050224002
"Block Group 3, Census Tract 237, Clackamas County, Oregon",472,303,169,472,59,413,472,0,20,9,55,11,30,30,10,0,9,41,84,54,39,32,48,41,005,023700,3,410050237003
"Block Group 5, Census Tract 1800, Douglas County, Oregon",446,300,146,446,90,356,446,9,20,0,23,56,6,0,20,60,43,58,53,49,8,15,26,41,019,180000,5,410191800005
"Block Group 2, Census Tract 800, Douglas County, Oregon",639,412,227,639,102,537,639,65,34,51,18,22,38,0,0,15,0,47,73,65,57,55,99,41,019,080000,2,410190800002
"Block Group 1, Census Tract 209, Clackamas County, Oregon",425,361,64,425,27,398,425,20,7,0,10,37,0,26,0,9,25,18,71,71,72,27,32,41,005,020900,1,410050209001
"Block Group 2, Census Tract 216.02, Clackamas County, Oregon",366,280,86,366,74,292,366,0,0,16,28,22,0,13,15,0,19,27,57,78,18,73,0,41,005,021602,2,410050216022
"Block Group 1, Census Tract 202, Clackamas County, Oregon",579,467,112,579,15,564,579,15,41,15,0,13,0,15,0,14,9,0,134,68,26,38,191,41,005,020200,1,410050202001
"Block Group 2, Census Tract 310.03, Washington County, Oregon",430,345,85,430,46,384,430,0,0,0,108,43,61,0,0,0,16,23,110,0,17,16,36,41,067,031003,2,410670310032
"Block Group 3, Census Tract 310.06, Washington County, Oregon",502,469,33,502,71,431,502,21,10,0,96,0,0,21,0,76,38,67,58,60,11,31,13,41,067,031006,3,410670310063
"Block Group 1, Census Tract 317.06, Washington County, Oregon",1092,989,103,1092,234,858,1092,42,22,31,31,76,81,166,54,44,22,102,332,46,16,15,12,41,067,031706,1,410670317061
"Block Group 2, Census Tract 316.10, Washington County, Oregon",651,574,77,651,85,566,651,64,38,25,15,0,12,42,46,31,64,52,115,80,12,55,0,41,067,031610,2,410670316102
"Block Group 3, Census Tract 321.04, Washington County, Oregon",547,500,47,547,12,535,547,0,0,9,0,0,13,0,8,0,16,27,47,141,79,73,134,41,067,032104,3,410670321043
"Block Group 1, Census Tract 324.10, Washington County, Oregon",677,483,194,677,28,649,677,0,18,28,6,16,0,0,37,42,34,92,141,195,8,60,0,41,067,032410,1,410670324101
"Block Group 1, Census Tract 37, Lane County, Oregon",759,692,67,759,33,726,759,206,98,70,80,26,40,10,12,14,32,31,71,7,32,10,20,41,039,003700,1,410390037001
"Block Group 1, Census Tract 52, Lane County, Oregon",478,274,204,478,92,386,478,8,25,0,17,0,23,12,44,10,0,85,120,20,29,59,26,41,039,005200,1,410390052001
"Block Group 3, Census Tract 35, Lane County, Oregon",284,270,14,284,0,284,284,0,0,0,8,0,33,17,46,4,9,13,39,0,70,24,21,41,039,003500,3,410390035003
"Block Group 3, Census Tract 36, Lane County, Oregon",628,539,89,628,102,526,628,45,29,8,14,28,11,71,0,42,27,50,78,56,18,87,64,41,039,003600,3,410390036003
"Block Group 2, Census Tract 36.01, Multnomah County, Oregon",694,622,72,694,72,622,694,46,0,47,44,17,8,25,71,20,29,69,103,66,20,117,12,41,051,003601,2,410510036012
"Block Group 1, Census Tract 22.02, Lane County, Oregon",1245,1072,173,1245,140,1105,1245,114,20,0,18,58,31,29,85,12,122,181,109,111,52,111,192,41,039,002202,1,410390022021
"Block Group 2, Census Tract 38, Lane County, Oregon",353,285,68,353,47,306,353,75,42,0,46,90,21,16,63,0,0,0,0,0,0,0,0,41,039,003800,2,410390038002
"Block Group 3, Census Tract 5.02, Marion County, Oregon",973,812,161,973,412,561,973,95,153,85,122,39,78,23,21,92,68,78,69,26,0,24,0,41,047,000502,3,410470005023
"Block Group 1, Census Tract 14.01, Marion County, Oregon",1067,573,494,1067,36,1031,1067,0,43,42,0,10,10,25,62,46,167,179,155,74,37,173,44,41,047,001401,1,410470014011
"Block Group 3, Census Tract 25.02, Marion County, Oregon",428,244,184,428,82,346,428,40,8,17,10,0,100,52,18,27,43,84,29,0,0,0,0,41,047,002502,3,410470025023
"Block Group 2, Census Tract 8.01, Multnomah County, Oregon",666,583,83,666,58,608,666,0,15,0,27,0,34,0,0,90,101,44,115,28,56,109,47,41,051,000801,2,410510008012
"Block Group 4, Census Tract 29.01, Multnomah County, Oregon",702,641,61,702,79,623,702,18,8,22,27,85,56,28,38,8,0,81,78,78,37,138,0,41,051,002901,4,410510029014
"Block Group 1, Census Tract 36.03, Multnomah County, Oregon",305,260,45,305,39,266,305,32,10,0,19,30,6,6,27,11,6,37,36,18,22,18,27,41,051,003603,1,410510036031
"Block Group 1, Census Tract 40.02, Multnomah County, Oregon",372,328,44,372,9,363,372,0,15,9,8,13,16,6,8,11,16,7,84,34,17,34,94,41,051,004002,1,410510040021
"Block Group 4, Census Tract 41.02, Multnomah County, Oregon",605,520,85,605,146,459,605,0,27,0,15,0,58,29,29,16,77,78,16,91,77,32,60,41,051,004102,4,410510041024
"Block Group 1, Census Tract 43, Multnomah County, Oregon",443,341,102,443,50,393,443,30,4,21,26,13,24,0,24,8,21,5,50,43,52,30,92,41,051,004300,1,410510043001
"Block Group 1, Census Tract 28.02, Multnomah County, Oregon",374,339,35,374,39,335,374,0,0,0,5,20,0,0,7,20,5,43,31,51,22,89,81,41,051,002802,1,410510028021
"Block Group 3, Census Tract 36.02, Multnomah County, Oregon",635,506,129,635,96,539,635,20,0,16,0,0,15,0,111,65,32,12,60,117,35,57,95,41,051,003602,3,410510036023
"Block Group 4, Census Tract 36.02, Multnomah County, Oregon",574,429,145,574,84,490,574,59,16,31,19,36,0,13,19,20,26,17,34,16,122,15,131,41,051,003602,4,410510036024
"Block Group 1, Census Tract 60.02, Multnomah County, Oregon",954,742,212,954,95,859,954,21,31,20,12,0,28,20,16,29,69,53,132,119,81,165,158,41,051,006002,1,410510060021
"Block Group 2, Census Tract 71, Multnomah County, Oregon",286,189,97,286,10,276,286,10,25,21,0,0,0,11,30,0,10,21,11,60,19,30,38,41,051,007100,2,410510071002
"Block Group 1, Census Tract 80.01, Multnomah County, Oregon",618,565,53,618,109,509,618,24,14,45,0,8,0,38,0,21,41,104,104,87,29,51,52,41,051,008001,1,410510080011
"Block Group 1, Census Tract 306, Washington County, Oregon",1127,850,277,1127,158,969,1127,44,79,75,18,34,14,0,44,45,44,94,125,209,114,75,113,41,067,030600,1,410670306001
"Block Group 2, Census Tract 40.01, Multnomah County, Oregon",415,377,38,415,106,309,415,0,87,0,0,0,17,16,0,18,15,38,50,83,20,56,15,41,051,004001,2,410510040012
"Block Group 1, Census Tract 40.01, Multnomah County, Oregon",910,700,210,910,390,520,910,81,41,265,55,55,32,46,73,34,44,46,0,90,13,17,18,41,051,004001,1,410510040011
"Block Group 2, Census Tract 52, Multnomah County, Oregon",604,430,174,604,205,399,604,235,32,52,31,35,17,72,31,0,14,16,20,33,0,0,16,41,051,005200,2,410510052002
"Block Group 2, Census Tract 60.01, Multnomah County, Oregon",279,220,59,279,14,265,279,6,7,4,6,0,0,0,0,0,0,5,49,36,14,47,105,41,051,006001,2,410510060012
"Block Group 1, Census Tract 9706, Wasco County, Oregon",505,442,63,505,14,491,505,9,8,13,0,3,23,34,3,19,49,49,150,98,1,0,46,41,065,970600,1,410659706001
"Block Group 1, Census Tract 9703, Wasco County, Oregon",284,194,90,284,6,278,284,0,0,9,30,14,9,16,0,15,14,23,23,81,7,23,20,41,065,970300,1,410659703001
"Block Group 1, Census Tract 7.01, Marion County, Oregon",1017,829,188,1017,363,654,1017,107,95,58,35,108,110,53,19,111,74,93,64,90,0,0,0,41,047,000701,1,410470007011
"Block Group 3, Census Tract 92.02, Multnomah County, Oregon",488,426,62,488,142,346,488,30,0,19,8,96,24,11,35,17,18,72,70,37,0,25,26,41,051,009202,3,410510092023
"Block Group 1, Census Tract 93.01, Multnomah County, Oregon",784,685,99,784,140,644,784,36,50,36,41,66,22,40,10,0,0,78,162,64,54,87,38,41,051,009301,1,410510093011
"Block Group 1, Census Tract 84, Multnomah County, Oregon",628,505,123,628,139,489,628,58,54,14,25,39,60,69,25,37,0,58,85,32,53,19,0,41,051,008400,1,410510084001
"Block Group 2, Census Tract 89.02, Multnomah County, Oregon",525,404,121,525,223,302,525,115,0,46,24,23,15,32,107,57,22,31,42,0,11,0,0,41,051,008902,2,410510089022
"Block Group 3, Census Tract 104.02, Multnomah County, Oregon",780,553,227,780,45,735,780,0,46,30,0,51,30,30,16,14,26,26,96,172,111,56,76,41,051,010402,3,410510104023
"Block Group 1, Census Tract 104.08, Multnomah County, Oregon",421,374,47,421,63,358,421,11,19,40,0,81,9,17,0,11,21,19,78,83,0,11,21,41,051,010408,1,410510104081
"Block Group 7, Census Tract 9502, Umatilla County, Oregon",276,164,112,276,30,246,276,61,22,0,0,53,8,0,0,6,28,37,16,21,24,0,0,41,059,950200,7,410599502007
"Block Group 1, Census Tract 108.02, Marion County, Oregon",559,454,105,559,122,437,559,39,0,0,24,73,0,32,0,46,25,89,36,14,134,14,33,41,047,010802,1,410470108021
"Block Group 3, Census Tract 108.02, Marion County, Oregon",419,324,95,419,93,326,419,31,7,6,44,22,35,25,14,17,44,64,52,31,10,17,0,41,047,010802,3,410470108023
"Block Group 1, Census Tract 18.01, Marion County, Oregon",687,535,152,687,276,411,687,85,20,154,41,13,15,0,38,42,119,94,34,0,32,0,0,41,047,001801,1,410470018011
"Block Group 2, Census Tract 228, Clackamas County, Oregon",808,336,472,808,13,795,808,27,42,0,54,15,42,28,12,40,42,78,37,99,71,84,137,41,005,022800,2,410050228002
"Block Group 1, Census Tract 232.02, Clackamas County, Oregon",324,289,35,324,46,278,324,0,0,19,0,0,0,0,0,0,0,66,125,16,0,61,37,41,005,023202,1,410050232021
"Block Group 3, Census Tract 232.02, Clackamas County, Oregon",1660,1481,179,1660,154,1506,1660,43,15,0,19,139,85,39,20,11,74,123,216,248,225,328,75,41,005,023202,3,410050232023
"Block Group 1, Census Tract 9503, Baker County, Oregon",400,238,162,400,66,334,400,7,35,27,0,38,20,15,13,54,51,0,35,82,9,14,0,41,001,950300,1,410019503001
"Block Group 2, Census Tract 9501, Baker County, Oregon",283,188,95,283,30,253,283,19,25,18,23,9,7,8,9,26,8,9,73,7,22,13,7,41,001,950100,2,410019501002
"Block Group 2, Census Tract 9504, Baker County, Oregon",310,142,168,310,64,246,310,9,11,33,30,28,18,14,19,0,28,46,43,25,6,0,0,41,001,950400,2,410019504002
"Block Group 3, Census Tract 9506, Baker County, Oregon",457,232,225,457,32,425,457,49,10,35,32,14,13,58,10,23,42,65,51,15,18,6,16,41,001,950600,3,410019506003
"Block Group 2, Census Tract 9506, Baker County, Oregon",274,194,80,274,69,205,274,16,17,21,10,20,20,21,24,14,36,31,11,4,13,16,0,41,001,950600,2,410019506002
"Block Group 1, Census Tract 9502, Baker County, Oregon",405,305,100,405,75,330,405,40,0,0,8,14,20,7,11,30,14,36,49,102,33,12,29,41,001,950200,1,410019502001
"Block Group 2, Census Tract 3611, Josephine County, Oregon",1166,839,327,1166,208,958,1166,124,103,107,14,14,94,115,62,0,104,208,135,49,16,21,0,41,033,361100,2,410333611002
"Block Group 2, Census Tract 3613, Josephine County, Oregon",812,554,258,812,88,724,812,20,0,39,41,62,19,75,71,56,78,72,78,51,102,13,35,41,033,361300,2,410333613002
"Block Group 3, Census Tract 16.04, Marion County, Oregon",711,562,149,711,206,505,711,60,0,12,15,44,0,54,16,102,74,149,106,28,28,6,17,41,047,001604,3,410470016043
"Block Group 2, Census Tract 13, Marion County, Oregon",775,618,157,775,178,597,775,67,51,60,61,72,0,18,8,0,81,141,70,49,0,44,53,41,047,001300,2,410470013002
"Block Group 2, Census Tract 15.01, Marion County, Oregon",541,438,103,541,51,490,541,8,9,17,0,0,0,16,5,17,36,60,83,137,72,44,37,41,047,001501,2,410470015012
"Block Group 3, Census Tract 16.02, Marion County, Oregon",540,472,68,540,145,395,540,0,111,0,0,0,54,83,0,12,13,76,136,30,15,10,0,41,047,001602,3,410470016023
"Block Group 1, Census Tract 18.02, Marion County, Oregon",509,413,96,509,91,418,509,24,0,16,0,14,0,12,0,0,66,39,157,114,39,28,0,41,047,001802,1,410470018021
"Block Group 4, Census Tract 18.02, Marion County, Oregon",719,692,27,719,125,594,719,13,14,15,0,58,21,9,33,14,106,108,127,174,13,14,0,41,047,001802,4,410470018024
"Block Group 2, Census Tract 23.01, Marion County, Oregon",364,306,58,364,22,342,364,0,0,7,8,9,9,25,0,0,19,74,89,3,35,19,67,41,047,002301,2,410470023012
"Block Group 4, Census Tract 9701, Morrow County, Oregon",615,582,33,615,78,537,615,21,5,30,26,44,17,3,25,37,71,61,150,39,49,33,4,41,049,970100,4,410499701004
"Block Group 1, Census Tract 9602, Lake County, Oregon",246,164,82,246,0,246,246,0,0,14,0,33,0,18,9,15,48,9,20,22,58,0,0,41,037,960200,1,410379602001
"Block Group 7, Census Tract 9602, Lake County, Oregon",312,192,120,312,105,207,312,0,53,44,80,23,0,0,25,0,28,11,12,36,0,0,0,41,037,960200,7,410379602007
"Block Group 6, Census Tract 9602, Lake County, Oregon",280,204,76,280,23,257,280,16,52,0,0,0,9,15,17,0,5,0,76,57,18,15,0,41,037,960200,6,410379602006
"Block Group 3, Census Tract 3.01, Multnomah County, Oregon",678,528,150,678,29,649,678,41,71,47,16,15,0,0,30,0,16,64,110,72,48,47,101,41,051,000301,3,410510003013
"Block Group 3, Census Tract 202.04, Polk County, Oregon",881,546,335,881,70,811,881,28,59,39,31,39,16,10,61,30,63,76,155,10,112,109,43,41,053,020204,3,410530202043
"Block Group 2, Census Tract 51, Polk County, Oregon",500,390,110,500,142,358,500,28,31,49,15,23,21,27,12,33,36,52,90,22,7,54,0,41,053,005100,2,410530051002
"Block Group 4, Census Tract 105.01, Marion County, Oregon",510,411,99,510,34,476,510,5,32,0,0,16,0,15,17,0,50,70,16,52,130,37,70,41,047,010501,4,410470105014
"Block Group 1, Census Tract 9501, Crook County, Oregon",391,276,115,391,49,342,391,0,0,0,0,22,44,0,52,44,34,13,67,38,16,61,0,41,013,950100,1,410139501001
"Block Group 1, Census Tract 9502, Crook County, Oregon",501,391,110,501,30,471,501,46,22,10,0,17,0,0,31,10,32,96,127,0,16,58,36,41,013,950200,1,410139502001
"Block Group 3, Census Tract 9502, Crook County, Oregon",474,331,143,474,245,229,474,34,26,29,33,48,86,40,20,0,33,88,37,0,0,0,0,41,013,950200,3,410139502003
"Block Group 3, Census Tract 9503, Crook County, Oregon",576,477,99,576,241,335,576,0,32,125,100,103,56,13,0,14,31,18,68,0,0,16,0,41,013,950300,3,410139503003
"Block Group 1, Census Tract 9503, Crook County, Oregon",295,187,108,295,110,185,295,7,0,87,22,24,13,0,12,25,41,10,54,0,0,0,0,41,013,950300,1,410139503001
"Block Group 2, Census Tract 9702, Wasco County, Oregon",456,410,46,456,96,360,456,13,8,11,18,4,55,27,40,49,84,41,52,37,0,17,0,41,065,970200,2,410659702002
"Block Group 1, Census Tract 9705, Wasco County, Oregon",401,299,102,401,135,266,401,0,12,42,67,0,8,7,0,7,60,19,78,25,10,59,7,41,065,970500,1,410659705001
"Block Group 1, Census Tract 9707, Wasco County, Oregon",234,180,54,234,10,224,234,10,7,8,13,18,0,14,0,7,19,47,17,35,17,11,11,41,065,970700,1,410659707001
"Block Group 1, Census Tract 9704, Wasco County, Oregon",511,365,146,511,217,294,511,22,25,36,75,38,34,64,17,16,35,92,17,21,0,0,19,41,065,970400,1,410659704001
"Block Group 2, Census Tract 39, Lane County, Oregon",1016,654,362,1016,436,580,1016,155,172,156,99,148,70,64,43,9,9,16,23,16,6,25,5,41,039,003900,2,410390039002
"Block Group 4, Census Tract 11, Coos County, Oregon",404,173,231,404,171,233,404,32,34,66,28,14,33,5,4,15,44,21,76,20,6,0,6,41,011,001100,4,410110011004
"Block Group 7, Census Tract 11, Coos County, Oregon",530,279,251,530,136,394,530,99,52,27,33,25,33,20,5,32,32,16,118,22,13,3,0,41,011,001100,7,410110011007
"Block Group 3, Census Tract 6, Coos County, Oregon",508,296,212,508,89,419,508,48,30,7,29,27,13,28,15,49,14,88,63,26,12,30,29,41,011,000600,3,410110006003
"Block Group 2, Census Tract 8, Coos County, Oregon",807,583,224,807,144,663,807,8,23,30,82,34,49,67,26,14,117,46,112,120,48,23,8,41,011,000800,2,410110008002
"Block Group 1, Census Tract 64.02, Multnomah County, Oregon",1132,1021,111,1132,0,1132,1132,0,0,0,0,0,60,0,35,0,97,52,131,100,157,173,327,41,051,006402,1,410510064021
"Block Group 1, Census Tract 70, Multnomah County, Oregon",340,255,85,340,0,340,340,31,14,0,0,28,15,0,0,0,16,0,18,13,13,55,137,41,051,007000,1,410510070001
"Block Group 1, Census Tract 72.01, Multnomah County, Oregon",488,387,101,488,92,396,488,10,21,8,0,47,8,0,46,0,35,51,103,111,29,19,0,41,051,007201,1,410510072011
"Block Group 2, Census Tract 106, Benton County, Oregon",404,251,153,404,41,363,404,115,41,21,45,72,0,22,0,11,0,0,57,15,5,0,0,41,003,010600,2,410030106002
"Block Group 4, Census Tract 104.08, Multnomah County, Oregon",534,410,124,534,145,389,534,10,34,50,19,27,40,37,13,128,36,116,24,0,0,0,0,41,051,010408,4,410510104084
"Block Group 2, Census Tract 9602, Harney County, Oregon",336,247,89,336,9,327,336,20,18,7,19,29,14,26,10,14,20,40,46,22,8,14,29,41,025,960200,2,410259602002
"Block Group 1, Census Tract 9601, Harney County, Oregon",616,449,167,616,112,504,616,29,27,26,69,58,36,2,4,66,14,79,99,26,11,51,19,41,025,960100,1,410259601001
"Block Group 4, Census Tract 313, Washington County, Oregon",817,574,243,817,85,732,817,75,27,14,12,54,17,47,55,48,59,30,160,83,27,40,69,41,067,031300,4,410670313004
"Block Group 2, Census Tract 29.03, Lane County, Oregon",686,441,245,686,14,672,686,25,9,9,19,10,25,16,27,10,75,85,99,94,102,63,18,41,039,002903,2,410390029032
"Block Group 1, Census Tract 23.01, Lane County, Oregon",1256,912,344,1256,351,905,1256,121,54,88,125,24,15,95,52,50,30,160,122,118,71,65,66,41,039,002301,1,410390023011
"Block Group 2, Census Tract 45.01, Lane County, Oregon",449,356,93,449,70,379,449,19,62,24,28,47,0,0,18,32,31,37,46,38,24,28,15,41,039,004501,2,410390045012
"Block Group 2, Census Tract 99.04, Multnomah County, Oregon",466,327,139,466,150,316,466,94,33,9,30,61,32,38,0,7,41,27,53,34,0,0,7,41,051,009904,2,410510099042
"Block Group 4, Census Tract 304.01, Linn County, Oregon",394,208,186,394,215,179,394,29,87,45,0,0,20,47,0,88,0,21,31,10,0,16,0,41,043,030401,4,410430304014
"Block Group 1, Census Tract 307, Linn County, Oregon",277,246,31,277,33,244,277,0,0,0,0,9,12,10,10,20,31,30,58,80,0,17,0,41,043,030700,1,410430307001
"Block Group 2, Census Tract 35.02, Multnomah County, Oregon",538,480,58,538,21,517,538,24,0,27,13,0,25,0,10,21,28,40,42,89,44,60,115,41,051,003502,2,410510035022
"Block Group 3, Census Tract 318.05, Washington County, Oregon",329,308,21,329,20,309,329,0,0,0,16,12,0,0,0,11,14,149,36,44,13,14,20,41,067,031805,3,410670318053
"Block Group 2, Census Tract 318.05, Washington County, Oregon",1002,939,63,1002,25,977,1002,0,10,0,0,0,0,0,18,21,45,54,145,185,162,132,230,41,067,031805,2,410670318052
"Block Group 2, Census Tract 326.03, Washington County, Oregon",438,407,31,438,0,438,438,0,0,0,0,0,12,9,38,0,0,17,39,76,71,62,114,41,067,032603,2,410670326032
"Block Group 2, Census Tract 325.03, Washington County, Oregon",508,400,108,508,56,452,508,0,0,68,8,22,24,18,21,39,55,16,54,27,86,63,7,41,067,032503,2,410670325032
"Block Group 3, Census Tract 203.04, Polk County, Oregon",1349,1016,333,1349,285,1064,1349,118,63,53,11,111,131,94,44,56,105,187,204,53,47,14,58,41,053,020304,3,410530203043
"Block Group 1, Census Tract 203.03, Polk County, Oregon",818,615,203,818,129,689,818,74,74,10,119,49,10,66,34,19,99,76,79,58,45,4,2,41,053,020303,1,410530203031
"Block Group 3, Census Tract 205, Polk County, Oregon",790,516,274,790,130,660,790,43,64,17,13,0,30,78,23,18,18,20,235,88,95,33,15,41,053,020500,3,410530205003
"Block Group 1, Census Tract 64.03, Multnomah County, Oregon",389,368,21,389,24,365,389,0,11,0,0,0,10,9,28,11,8,9,63,68,79,46,47,41,051,006403,1,410510064031
"Block Group 2, Census Tract 104.10, Multnomah County, Oregon",784,646,138,784,257,527,784,55,69,87,63,25,53,96,9,6,70,63,70,101,10,7,0,41,051,010410,2,410510104102
"Block Group 3, Census Tract 307.01, Yamhill County, Oregon",599,453,146,599,43,556,599,13,12,0,0,20,72,12,38,67,50,38,14,129,36,45,53,41,071,030701,3,410710307013
"Block Group 2, Census Tract 301.02, Yamhill County, Oregon",1399,1245,154,1399,88,1311,1399,47,0,0,0,55,13,46,47,111,37,102,390,194,147,158,52,41,071,030102,2,410710301022
"Block Group 1, Census Tract 306.02, Yamhill County, Oregon",1149,911,238,1149,92,1057,1149,36,29,0,0,19,22,0,82,63,108,209,270,35,72,102,102,41,071,030602,1,410710306021
"Block Group 3, Census Tract 306.01, Yamhill County, Oregon",202,121,81,202,24,178,202,12,37,0,9,22,0,0,0,0,37,0,26,17,8,10,24,41,071,030601,3,410710306013
"Block Group 2, Census Tract 301.01, Yamhill County, Oregon",1085,892,193,1085,43,1042,1085,14,0,0,12,50,28,0,29,50,69,39,186,68,42,157,341,41,071,030101,2,410710301012
"Block Group 3, Census Tract 303.01, Yamhill County, Oregon",394,261,133,394,59,335,394,22,0,49,0,0,0,22,0,12,12,67,11,34,98,20,47,41,071,030301,3,410710303013
"Block Group 0, Census Tract 9900, Clatsop County, Oregon",0,0,0,0,0,0,0,0,0,0,0,0,0,0,0,0,0,0,0,0,0,0,0,41,007,990000,0,410079900000
"Block Group 4, Census Tract 310.04, Washington County, Oregon",1266,616,650,1266,85,1181,1266,70,0,48,161,52,50,48,85,41,52,129,123,149,96,113,49,41,067,031004,4,410670310044
"Block Group 4, Census Tract 3611, Josephine County, Oregon",1096,837,259,1096,290,806,1096,43,53,62,13,158,70,117,105,47,127,60,189,12,0,40,0,41,033,361100,4,410333611004
"Block Group 3, Census Tract 202, Clackamas County, Oregon",375,200,175,375,27,348,375,38,16,0,11,16,0,0,51,0,72,0,34,23,15,16,83,41,005,020200,3,410050202003
"Block Group 1, Census Tract 205.03, Clackamas County, Oregon",522,421,101,522,20,502,522,25,10,0,9,20,11,5,10,10,5,36,96,40,41,77,127,41,005,020503,1,410050205031
"Block Group 1, Census Tract 9503, Umatilla County, Oregon",362,289,73,362,38,324,362,13,16,10,8,10,6,0,0,31,22,36,36,45,9,58,62,41,059,950300,1,410599503001
"Block Group 2, Census Tract 9504, Umatilla County, Oregon",187,131,56,187,53,134,187,10,68,0,0,0,10,0,37,0,16,3,26,0,0,9,8,41,059,950400,2,410599504002
"Block Group 4, Census Tract 9504, Umatilla County, Oregon",211,181,30,211,42,169,211,0,0,0,9,0,0,0,7,9,9,17,30,69,33,18,10,41,059,950400,4,410599504004
"Block Group 5, Census Tract 9506, Umatilla County, Oregon",624,371,253,624,143,481,624,66,77,31,39,0,0,21,19,0,29,40,85,63,116,38,0,41,059,950600,5,410599506005
"Block Group 2, Census Tract 2, Multnomah County, Oregon",1050,680,370,1050,124,926,1050,108,53,51,28,62,0,17,27,0,28,238,113,43,59,77,146,41,051,000200,2,410510002002
"Block Group 1, Census Tract 2, Multnomah County, Oregon",459,420,39,459,32,427,459,16,0,47,16,0,0,16,65,27,30,53,82,33,13,33,28,41,051,000200,1,410510002001
"Block Group 1, Census Tract 4.02, Multnomah County, Oregon",559,476,83,559,98,461,559,0,7,48,21,20,51,31,9,22,51,36,119,62,36,32,14,41,051,000402,1,410510004021
"Block Group 1, Census Tract 15, Multnomah County, Oregon",647,511,136,647,36,611,647,10,14,0,29,13,23,31,0,23,0,41,59,97,25,20,262,41,051,001500,1,410510015001
"Block Group 1, Census Tract 100.02, Multnomah County, Oregon",1010,789,221,1010,183,827,1010,106,0,27,51,68,29,14,41,51,111,69,141,145,59,78,20,41,051,010002,1,410510100021
"Block Group 1, Census Tract 77, Multnomah County, Oregon",435,361,74,435,94,341,435,13,20,8,37,60,24,25,19,0,20,21,79,60,15,34,0,41,051,007700,1,410510077001
"Block Group 1, Census Tract 81, Multnomah County, Oregon",1069,799,270,1069,308,761,1069,123,99,52,44,56,43,31,61,50,218,109,69,38,27,49,0,41,051,008100,1,410510081001
"Block Group 2, Census Tract 87, Multnomah County, Oregon",697,636,61,697,94,603,697,27,0,33,9,9,46,30,50,20,103,42,110,95,86,37,0,41,051,008700,2,410510087002
"Block Group 1, Census Tract 9707, Malheur County, Oregon",628,439,189,628,102,526,628,33,49,29,54,31,22,22,63,29,66,85,52,40,11,15,27,41,045,970700,1,410459707001
"Block Group 4, Census Tract 1, Multnomah County, Oregon",497,381,116,497,0,497,497,0,29,30,34,17,0,48,14,0,25,34,62,26,48,85,45,41,051,000100,4,410510001004
"Block Group 4, Census Tract 6.02, Multnomah County, Oregon",421,413,8,421,125,296,421,19,0,0,19,6,0,0,42,22,31,83,135,38,0,26,0,41,051,000602,4,410510006024
"Block Group 1, Census Tract 8.01, Multnomah County, Oregon",549,408,141,549,67,482,549,65,50,0,0,21,0,30,19,37,0,65,126,71,32,0,33,41,051,000801,1,410510008011
"Block Group 3, Census Tract 7.01, Multnomah County, Oregon",588,491,97,588,129,459,588,32,0,21,0,10,47,46,32,17,87,82,55,23,39,54,43,41,051,000701,3,410510007013
"Block Group 4, Census Tract 7.01, Multnomah County, Oregon",422,351,71,422,88,334,422,23,14,44,10,9,31,0,9,21,44,26,92,30,45,24,0,41,051,000701,4,410510007014
"Block Group 1, Census Tract 16.02, Multnomah County, Oregon",411,363,48,411,47,364,411,20,30,10,71,0,9,19,28,41,17,38,63,37,0,28,0,41,051,001602,1,410510016021
"Block Group 1, Census Tract 72.02, Multnomah County, Oregon",1267,1070,197,1267,288,979,1267,55,6,31,16,8,110,27,56,86,67,217,165,169,132,60,62,41,051,007202,1,410510072021
"Block Group 2, Census Tract 79, Multnomah County, Oregon",1115,956,159,1115,105,1010,1115,56,7,32,36,9,14,60,83,123,119,164,122,161,59,30,40,41,051,007900,2,410510079002
"Block Group 3, Census Tract 82.02, Multnomah County, Oregon",649,543,106,649,265,384,649,37,16,0,68,69,0,58,0,42,83,144,44,65,0,23,0,41,051,008202,3,410510082023
"Block Group 1, Census Tract 93.02, Multnomah County, Oregon",1116,957,159,1116,313,803,1116,42,0,90,37,125,57,41,37,19,75,127,147,104,143,72,0,41,051,009302,1,410510093021
"Block Group 1, Census Tract 97.01, Multnomah County, Oregon",1001,720,281,1001,526,475,1001,125,72,130,108,87,29,9,48,74,10,20,104,107,64,0,14,41,051,009701,1,410510097011
"Block Group 1, Census Tract 103.03, Multnomah County, Oregon",1074,894,180,1074,261,813,1074,94,40,21,35,26,22,0,128,54,63,57,282,89,12,87,64,41,051,010303,1,410510103031
"Block Group 3, Census Tract 1, Multnomah County, Oregon",285,271,14,285,0,285,285,0,0,0,0,14,16,17,0,24,0,11,0,99,62,18,24,41,051,000100,3,410510001003
"Block Group 1, Census Tract 326.06, Washington County, Oregon",436,207,229,436,29,407,436,0,14,14,0,13,12,46,36,0,76,29,45,26,53,54,18,41,067,032606,1,410670326061
"Block Group 2, Census Tract 28, Lane County, Oregon",584,450,134,584,146,438,584,33,8,15,17,36,9,18,83,44,35,108,62,54,23,39,0,41,039,002800,2,410390028002
"Block Group 3, Census Tract 28, Lane County, Oregon",542,366,176,542,109,433,542,57,24,9,34,30,18,13,15,29,75,60,80,36,23,39,0,41,039,002800,3,410390028003
"Block Group 3, Census Tract 213, Clackamas County, Oregon",359,239,120,359,26,333,359,14,0,0,14,0,0,16,15,0,28,61,73,34,45,45,14,41,005,021300,3,410050213003
"Block Group 4, Census Tract 204.01, Clackamas County, Oregon",721,555,166,721,13,708,721,5,0,15,66,1,16,15,36,25,40,46,87,64,77,121,107,41,005,020401,4,410050204014
"Block Group 1, Census Tract 204.01, Clackamas County, Oregon",521,448,73,521,15,506,521,0,0,13,0,0,0,14,0,0,0,0,76,73,48,24,273,41,005,020401,1,410050204011
"Block Group 1, Census Tract 3614, Josephine County, Oregon",455,206,249,455,38,417,455,72,8,46,23,10,19,31,27,31,0,47,58,29,10,0,44,41,033,361400,1,410333614001
"Block Group 3, Census Tract 3607.01, Josephine County, Oregon",374,286,88,374,197,177,374,97,41,18,22,23,10,22,24,0,38,10,47,12,0,0,10,41,033,360701,3,410333607013
"Block Group 2, Census Tract 3603, Josephine County, Oregon",527,405,122,527,160,367,527,17,79,51,0,0,34,18,68,0,33,17,138,0,18,54,0,41,033,360300,2,410333603002
"Block Group 1, Census Tract 3604, Josephine County, Oregon",733,329,404,733,85,648,733,19,0,18,40,14,59,32,41,17,71,113,109,42,37,40,81,41,033,360400,1,410333604001
"Block Group 4, Census Tract 3612, Josephine County, Oregon",445,317,128,445,82,363,445,0,15,15,0,19,18,45,12,20,86,123,37,0,0,37,18,41,033,361200,4,410333612004
"Block Group 2, Census Tract 99.06, Multnomah County, Oregon",478,382,96,478,31,447,478,0,0,0,21,17,21,0,8,24,61,59,44,55,76,37,55,41,051,009906,2,410510099062
"Block Group 1, Census Tract 106, Multnomah County, Oregon",561,285,276,561,175,386,561,239,57,0,33,35,64,0,0,0,9,0,86,24,0,0,14,41,051,010600,1,410510106001
"Block Group 2, Census Tract 23.03, Multnomah County, Oregon",1249,912,337,1249,146,1103,1249,66,141,64,67,12,51,37,89,33,95,152,85,158,74,91,34,41,051,002303,2,410510023032
"Block Group 3, Census Tract 22.03, Multnomah County, Oregon",460,441,19,460,57,403,460,32,0,0,0,0,19,10,57,30,56,33,55,39,36,31,62,41,051,002203,3,410510022033
"Block Group 4, Census Tract 307.02, Yamhill County, Oregon",861,615,246,861,157,704,861,91,0,0,0,73,44,0,75,100,41,132,101,38,14,85,67,41,071,030702,4,410710307024
"Block Group 3, Census Tract 308.02, Yamhill County, Oregon",448,404,44,448,119,329,448,15,17,11,0,9,9,21,33,61,34,103,64,27,0,10,34,41,071,030802,3,410710308023
"Block Group 2, Census Tract 18.02, Multnomah County, Oregon",652,600,52,652,71,581,652,17,6,20,22,31,41,45,46,0,9,52,69,86,79,47,82,41,051,001802,2,410510018022
"Block Group 1, Census Tract 21, Multnomah County, Oregon",732,664,68,732,91,641,732,72,50,26,80,7,8,35,69,58,47,112,68,30,60,0,10,41,051,002100,1,410510021001
"Block Group 2, Census Tract 24.02, Multnomah County, Oregon",732,396,336,732,0,732,732,61,20,15,0,16,32,28,52,36,69,78,75,66,91,26,67,41,051,002402,2,410510024022
"Block Group 3, Census Tract 29.03, Multnomah County, Oregon",322,264,58,322,152,170,322,48,32,0,17,0,0,72,35,0,19,35,37,11,16,0,0,41,051,002903,3,410510029033
"Block Group 3, Census Tract 33.01, Multnomah County, Oregon",475,384,91,475,126,349,475,54,0,138,0,11,0,0,17,0,24,84,51,18,31,44,3,41,051,003301,3,410510033013
"Block Group 1, Census Tract 37.02, Multnomah County, Oregon",286,258,28,286,19,267,286,0,4,0,0,0,0,28,0,0,12,30,27,48,43,45,49,41,051,003702,1,410510037021
"Block Group 3, Census Tract 38.01, Multnomah County, Oregon",609,564,45,609,71,538,609,38,0,21,16,10,0,47,20,0,93,51,46,52,71,56,88,41,051,003801,3,410510038013
"Block Group 1, Census Tract 317.04, Washington County, Oregon",536,365,171,536,12,524,536,0,0,0,0,35,56,0,0,18,92,46,48,134,16,91,0,41,067,031704,1,410670317041
"Block Group 4, Census Tract 101, Multnomah County, Oregon",662,488,174,662,90,572,662,21,14,45,33,70,79,47,0,15,121,74,111,17,15,0,0,41,051,010100,4,410510101004
"Block Group 2, Census Tract 103.06, Multnomah County, Oregon",717,609,108,717,135,582,717,9,12,26,36,26,21,65,10,42,33,87,54,193,51,7,45,41,051,010306,2,410510103062
"Block Group 2, Census Tract 104.09, Multnomah County, Oregon",761,652,109,761,90,671,761,0,0,15,0,13,14,7,31,32,57,76,130,153,29,152,52,41,051,010409,2,410510104092
"Block Group 2, Census Tract 3612, Josephine County, Oregon",803,581,222,803,223,580,803,37,62,13,10,15,131,43,51,27,14,116,174,71,17,22,0,41,033,361200,2,410333612002
"Block Group 2, Census Tract 3609, Josephine County, Oregon",288,93,195,288,21,267,288,0,11,32,28,18,20,10,12,0,56,23,26,31,10,11,0,41,033,360900,2,410333609002
"Block Group 5, Census Tract 3606, Josephine County, Oregon",386,315,71,386,135,251,386,39,37,14,0,109,0,47,0,0,10,44,68,18,0,0,0,41,033,360600,5,410333606005
"Block Group 4, Census Tract 3606, Josephine County, Oregon",476,372,104,476,196,280,476,64,52,14,76,0,23,80,38,15,30,11,26,25,0,0,22,41,033,360600,4,410333606004
"Block Group 4, Census Tract 27, Marion County, Oregon",359,221,138,359,0,359,359,0,22,0,0,0,21,0,0,0,30,54,72,51,37,60,12,41,047,002700,4,410470027004
"Block Group 0, Census Tract 9900, Douglas County, Oregon",0,0,0,0,0,0,0,0,0,0,0,0,0,0,0,0,0,0,0,0,0,0,0,41,019,990000,0,410199900000
"Block Group 1, Census Tract 315.13, Washington County, Oregon",1248,1164,84,1248,28,1220,1248,0,0,17,44,0,0,33,0,0,0,57,14,28,117,256,682,41,067,031513,1,410670315131
"Block Group 2, Census Tract 301.01, Washington County, Oregon",474,301,173,474,0,474,474,11,0,27,22,30,11,20,43,0,11,33,50,88,26,22,80,41,067,030101,2,410670301012
"Block Group 2, Census Tract 301.02, Washington County, Oregon",1449,1198,251,1449,0,1449,1449,0,0,0,0,14,17,29,0,13,59,38,208,83,63,240,685,41,067,030102,2,410670301022
"Block Group 3, Census Tract 316.15, Washington County, Oregon",497,408,89,497,23,474,497,12,21,0,17,31,16,0,37,0,27,55,158,46,31,22,24,41,067,031615,3,410670316153
"Block Group 2, Census Tract 324.08, Washington County, Oregon",1813,1644,169,1813,30,1783,1813,0,57,16,0,16,35,17,0,0,38,36,278,179,285,314,542,41,067,032408,2,410670324082
"Block Group 1, Census Tract 326.10, Washington County, Oregon",661,573,88,661,44,617,661,5,18,6,16,9,0,18,0,11,59,94,124,56,64,98,83,41,067,032610,1,410670326101
"Block Group 1, Census Tract 318.14, Washington County, Oregon",355,312,43,355,27,328,355,8,0,0,0,18,12,20,0,11,13,36,48,67,46,50,26,41,067,031814,1,410670318141
"Block Group 1, Census Tract 323, Washington County, Oregon",2040,1836,204,2040,201,1839,2040,50,22,33,26,71,37,57,53,48,146,311,305,228,221,276,156,41,067,032300,1,410670323001
"Block Group 2, Census Tract 326.06, Washington County, Oregon",614,527,87,614,305,309,614,53,0,0,0,55,221,10,35,0,83,115,16,22,0,4,0,41,067,032606,2,410670326062
"Block Group 2, Census Tract 9501, Clatsop County, Oregon",512,395,117,512,28,484,512,0,21,30,20,35,12,14,5,44,29,81,83,16,53,40,29,41,007,950100,2,410079501002
"Block Group 2, Census Tract 9507, Clatsop County, Oregon",393,214,179,393,50,343,393,3,9,41,29,11,19,18,9,26,15,30,66,32,46,15,24,41,007,950700,2,410079507002
"Block Group 2, Census Tract 9504, Clatsop County, Oregon",668,456,212,668,80,588,668,34,36,8,16,21,30,20,33,37,28,82,91,170,23,39,0,41,007,950400,2,410079504002
"Block Group 4, Census Tract 9511, Clatsop County, Oregon",350,207,143,350,40,310,350,54,0,0,11,0,15,15,20,0,15,30,85,56,0,5,44,41,007,951100,4,410079511004
"Block Group 3, Census Tract 2, Coos County, Oregon",239,170,69,239,22,217,239,0,0,4,25,12,11,19,0,12,108,16,23,0,9,0,0,41,011,000200,3,410110002003
"Block Group 2, Census Tract 331.02, Washington County, Oregon",518,362,156,518,103,415,518,38,19,40,8,18,0,20,26,7,44,123,96,26,0,21,32,41,067,033102,2,410670331022
"Block Group 1, Census Tract 319.11, Washington County, Oregon",1203,1038,165,1203,130,1073,1203,71,25,50,33,49,66,24,25,63,63,216,190,99,64,113,52,41,067,031911,1,410670319111
"Block Group 2, Census Tract 45.02, Lane County, Oregon",434,373,61,434,73,361,434,105,26,33,59,41,19,10,12,0,16,15,46,28,9,15,0,41,039,004502,2,410390045022
"Block Group 3, Census Tract 48, Multnomah County, Oregon",587,572,15,587,128,459,587,39,50,0,0,97,19,14,41,0,64,39,106,78,0,27,13,41,051,004800,3,410510048003
"Block Group 4, Census Tract 52, Multnomah County, Oregon",1092,902,190,1092,52,1040,1092,74,49,31,20,50,14,20,28,37,111,106,208,152,125,40,27,41,051,005200,4,410510052004
"Block Group 4, Census Tract 56, Multnomah County, Oregon",744,591,153,744,34,710,744,86,18,33,62,0,0,0,0,0,70,84,107,92,18,37,137,41,051,005600,4,410510056004
"Block Group 1, Census Tract 16.01, Multnomah County, Oregon",428,377,51,428,84,344,428,0,13,18,0,14,28,0,0,19,0,32,176,33,13,15,67,41,051,001601,1,410510016011
"Block Group 5, Census Tract 16.01, Multnomah County, Oregon",480,302,178,480,104,376,480,21,99,16,0,0,0,37,0,0,16,18,98,51,0,85,39,41,051,001601,5,410510016015
"Block Group 4, Census Tract 6.01, Multnomah County, Oregon",605,514,91,605,183,422,605,40,0,10,22,12,41,31,10,65,26,101,82,75,18,27,45,41,051,000601,4,410510006014
"Block Group 3, Census Tract 6.01, Multnomah County, Oregon",311,276,35,311,52,259,311,24,0,13,0,13,23,26,14,7,0,24,68,39,21,0,39,41,051,000601,3,410510006013
"Block Group 3, Census Tract 9.01, Multnomah County, Oregon",489,454,35,489,129,360,489,0,0,29,0,22,16,0,0,29,12,68,102,105,54,0,52,41,051,000901,3,410510009013
"Block Group 3, Census Tract 24.03, Lane County, Oregon",430,321,109,430,45,385,430,12,9,34,0,22,9,38,16,27,21,57,77,61,12,31,4,41,039,002403,3,410390024033
"Block Group 1, Census Tract 9506.01, Lincoln County, Oregon",193,151,42,193,6,187,193,12,46,0,0,11,5,15,0,21,0,37,36,0,0,0,10,41,041,950601,1,410419506011
"Block Group 4, Census Tract 5.04, Coos County, Oregon",328,203,125,328,158,170,328,63,17,0,0,20,14,9,0,0,88,76,10,0,20,0,11,41,011,000504,4,410110005044
"Block Group 0, Census Tract 9901.01, Coos County, Oregon",0,0,0,0,0,0,0,0,0,0,0,0,0,0,0,0,0,0,0,0,0,0,0,41,011,990101,0,410119901010
"Block Group 1, Census Tract 33.01, Lane County, Oregon",524,439,85,524,114,410,524,17,16,92,6,36,52,0,0,92,88,6,81,10,22,6,0,41,039,003301,1,410390033011
"Block Group 2, Census Tract 229.07, Clackamas County, Oregon",602,509,93,602,171,431,602,0,40,30,40,19,19,72,0,48,107,66,119,21,0,21,0,41,005,022907,2,410050229072
"Block Group 1, Census Tract 9506.02, Lincoln County, Oregon",458,192,266,458,97,361,458,62,43,76,5,26,41,24,0,73,31,7,45,10,8,0,7,41,041,950602,1,410419506021
"Block Group 2, Census Tract 9503.04, Lincoln County, Oregon",361,282,79,361,128,233,361,25,9,10,25,33,27,33,18,18,20,24,70,35,7,7,0,41,041,950304,2,410419503042
"Block Group 1, Census Tract 229.06, Clackamas County, Oregon",737,391,346,737,164,573,737,28,21,53,20,135,34,45,50,40,79,75,79,60,11,7,0,41,005,022906,1,410050229061
"Block Group 1, Census Tract 319.09, Washington County, Oregon",1047,958,89,1047,60,987,1047,0,4,9,12,34,45,25,12,0,55,33,183,159,216,168,92,41,067,031909,1,410670319091
"Block Group 1, Census Tract 319.12, Washington County, Oregon",795,697,98,795,96,699,795,7,11,11,9,9,22,15,13,25,20,93,87,118,97,184,74,41,067,031912,1,410670319121
"Block Group 1, Census Tract 324.09, Washington County, Oregon",653,627,26,653,303,350,653,61,18,8,51,23,96,71,30,48,90,78,35,10,20,0,14,41,067,032409,1,410670324091
"Block Group 2, Census Tract 333.02, Washington County, Oregon",1299,954,345,1299,41,1258,1299,41,20,0,19,3,20,27,33,27,47,76,161,194,180,201,250,41,067,033302,2,410670333022
"Block Group 5, Census Tract 324.06, Washington County, Oregon",578,421,157,578,4,574,578,81,0,0,0,17,42,0,0,29,14,93,122,69,24,73,14,41,067,032406,5,410670324065
"Block Group 3, Census Tract 88, Multnomah County, Oregon",531,500,31,531,45,486,531,17,0,24,9,9,0,7,21,13,69,57,54,67,102,46,36,41,051,008800,3,410510088003
"Block Group 1, Census Tract 92.01, Multnomah County, Oregon",782,591,191,782,236,546,782,82,66,75,14,30,69,51,0,53,45,31,166,31,53,16,0,41,051,009201,1,410510092011
