NAME,B25003_001E,B25003_002E,B25003_003E,state,county,tract,block group
"Block Group 1, Census Tract 24, Jackson County, Oregon",390,339,51,41,029,002400,1
"Block Group 1, Census Tract 9508, Lincoln County, Oregon",667,514,153,41,041,950800,1
"Block Group 2, Census Tract 9508, Lincoln County, Oregon",935,508,427,41,041,950800,2
"Block Group 1, Census Tract 9514, Lincoln County, Oregon",670,509,161,41,041,951400,1
"Block Group 2, Census Tract 9514, Lincoln County, Oregon",549,294,255,41,041,951400,2
"Block Group 2, Census Tract 27, Jackson County, Oregon",644,542,102,41,029,002700,2
"Block Group 3, Census Tract 27, Jackson County, Oregon",1401,1110,291,41,029,002700,3
"Block Group 1, Census Tract 27, Jackson County, Oregon",418,295,123,41,029,002700,1
"Block Group 4, Census Tract 27, Jackson County, Oregon",711,513,198,41,029,002700,4
"Block Group 3, Census Tract 11, Jackson County, Oregon",427,357,70,41,029,001100,3
"Block Group 2, Census Tract 11, Jackson County, Oregon",1137,970,167,41,029,001100,2
"Block Group 1, Census Tract 11, Jackson County, Oregon",521,452,69,41,029,001100,1
"Block Group 1, Census Tract 13.01, Jackson County, Oregon",515,396,119,41,029,001301,1
"Block Group 3, Census Tract 13.01, Jackson County, Oregon",308,235,73,41,029,001301,3
"Block Group 2, Census Tract 21, Jackson County, Oregon",444,165,279,41,029,002100,2
"Block Group 3, Census Tract 21, Jackson County, Oregon",420,277,143,41,029,002100,3
"Block Group 5, Census Tract 29, Jackson County, Oregon",609,397,212,41,029,002900,5
"Block Group 1, Census Tract 29, Jackson County, Oregon",392,244,148,41,029,002900,1
"Block Group 2, Census Tract 29, Jackson County, Oregon",711,613,98,41,029,002900,2
"Block Group 6, Census Tract 29, Jackson County, Oregon",381,270,111,41,029,002900,6
"Block Group 3, Census Tract 18, Jackson County, Oregon",1119,831,288,41,029,001800,3
"Block Group 1, Census Tract 18, Jackson County, Oregon",722,488,234,41,029,001800,1
"Block Group 2, Census Tract 18, Jackson County, Oregon",1153,898,255,41,029,001800,2
"Block Group 2, Census Tract 20, Jackson County, Oregon",505,207,298,41,029,002000,2
"Block Group 1, Census Tract 28, Jackson County, Oregon",652,514,138,41,029,002800,1
"Block Group 3, Census Tract 28, Jackson County, Oregon",266,256,10,41,029,002800,3
"Block Group 1, Census Tract 8, Jackson County, Oregon",1536,897,639,41,029,000800,1
"Block Group 1, Census Tract 7, Jackson County, Oregon",680,432,248,41,029,000700,1
"Block Group 2, Census Tract 7, Jackson County, Oregon",1037,911,126,41,029,000700,2
"Block Group 2, Census Tract 500.01, Douglas County, Oregon",765,561,204,41,019,050001,2
"Block Group 1, Census Tract 500.01, Douglas County, Oregon",303,294,9,41,019,050001,1
"Block Group 4, Census Tract 500.01, Douglas County, Oregon",309,284,25,41,019,050001,4
"Block Group 1, Census Tract 1800, Douglas County, Oregon",454,388,66,41,019,180000,1
"Block Group 4, Census Tract 1800, Douglas County, Oregon",237,89,148,41,019,180000,4
"Block Group 1, Census Tract 9704, Klamath County, Oregon",554,440,114,41,035,970400,1
"Block Group 2, Census Tract 9714, Klamath County, Oregon",413,235,178,41,035,971400,2
"Block Group 3, Census Tract 9714, Klamath County, Oregon",230,164,66,41,035,971400,3
"Block Group 4, Census Tract 9715, Klamath County, Oregon",375,162,213,41,035,971500,4
"Block Group 1, Census Tract 9715, Klamath County, Oregon",269,163,106,41,035,971500,1
"Block Group 5, Census Tract 9715, Klamath County, Oregon",560,382,178,41,035,971500,5
"Block Group 2, Census Tract 9715, Klamath County, Oregon",352,168,184,41,035,971500,2
"Block Group 3, Census Tract 9718, Klamath County, Oregon",371,36,335,41,035,971800,3
"Block Group 1, Census Tract 9504, Lincoln County, Oregon",901,450,451,41,041,950400,1
"Block Group 3, Census Tract 30.02, Jackson County, Oregon",688,519,169,41,029,003002,3
"Block Group 1, Census Tract 9501, Lincoln County, Oregon",884,610,274,41,041,950100,1
"Block Group 2, Census Tract 9501, Lincoln County, Oregon",456,364,92,41,041,950100,2
"Block Group 1, Census Tract 9511, Lincoln County, Oregon",353,235,118,41,041,951100,1
"Block Group 2, Census Tract 9511, Lincoln County, Oregon",466,322,144,41,041,951100,2
"Block Group 1, Census Tract 9516, Lincoln County, Oregon",611,444,167,41,041,951600,1
"Block Group 3, Census Tract 9516, Lincoln County, Oregon",404,331,73,41,041,951600,3
"Block Group 2, Census Tract 9516, Lincoln County, Oregon",595,357,238,41,041,951600,2
"Block Group 1, Census Tract 9509, Lincoln County, Oregon",326,171,155,41,041,950900,1
"Block Group 3, Census Tract 9509, Lincoln County, Oregon",464,254,210,41,041,950900,3
"Block Group 2, Census Tract 9509, Lincoln County, Oregon",301,137,164,41,041,950900,2
"Block Group 4, Census Tract 9509, Lincoln County, Oregon",390,226,164,41,041,950900,4
"Block Group 2, Census Tract 9512, Lincoln County, Oregon",389,233,156,41,041,951200,2
"Block Group 1, Census Tract 28, Marion County, Oregon",520,412,108,41,047,002800,1
"Block Group 2, Census Tract 28, Marion County, Oregon",1026,639,387,41,047,002800,2
"Block Group 2, Census Tract 101, Marion County, Oregon",209,132,77,41,047,010100,2
"Block Group 1, Census Tract 106, Marion County, Oregon",109,73,36,41,047,010600,1
"Block Group 2, Census Tract 222.01, Clackamas County, Oregon",1582,233,1349,41,005,022201,2
"Block Group 1, Census Tract 222.01, Clackamas County, Oregon",202,119,83,41,005,022201,1
"Block Group 2, Census Tract 235, Clackamas County, Oregon",534,534,0,41,005,023500,2
"Block Group 5, Census Tract 235, Clackamas County, Oregon",373,289,84,41,005,023500,5
"Block Group 1, Census Tract 235, Clackamas County, Oregon",533,428,105,41,005,023500,1
"Block Group 1, Census Tract 238, Clackamas County, Oregon",463,403,60,41,005,023800,1
"Block Group 3, Census Tract 238, Clackamas County, Oregon",200,174,26,41,005,023800,3
"Block Group 5, Census Tract 238, Clackamas County, Oregon",410,310,100,41,005,023800,5
"Block Group 2, Census Tract 216.01, Clackamas County, Oregon",1307,540,767,41,005,021601,2
"Block Group 3, Census Tract 216.01, Clackamas County, Oregon",469,289,180,41,005,021601,3
"Block Group 3, Census Tract 9701, Klamath County, Oregon",282,106,176,41,035,970100,3
"Block Group 1, Census Tract 9701, Klamath County, Oregon",192,122,70,41,035,970100,1
"Block Group 2, Census Tract 30.02, Jackson County, Oregon",625,438,187,41,029,003002,2
"Block Group 1, Census Tract 25, Jackson County, Oregon",475,444,31,41,029,002500,1
"Block Group 2, Census Tract 25, Jackson County, Oregon",306,261,45,41,029,002500,2
"Block Group 2, Census Tract 9, Jackson County, Oregon",1059,810,249,41,029,000900,2
"Block Group 1, Census Tract 9, Jackson County, Oregon",426,354,72,41,029,000900,1
"Block Group 1, Census Tract 14, Jackson County, Oregon",1814,1372,442,41,029,001400,1
"Block Group 2, Census Tract 23, Jackson County, Oregon",388,355,33,41,029,002300,2
"Block Group 1, Census Tract 2.01, Jackson County, Oregon",456,80,376,41,029,000201,1
"Block Group 3, Census Tract 2.01, Jackson County, Oregon",542,53,489,41,029,000201,3
"Block Group 1, Census Tract 15, Jackson County, Oregon",359,304,55,41,029,001500,1
"Block Group 2, Census Tract 15, Jackson County, Oregon",822,649,173,41,029,001500,2
"Block Group 2, Census Tract 24, Jackson County, Oregon",339,284,55,41,029,002400,2
"Block Group 1, Census Tract 9505, Umatilla County, Oregon",656,319,337,41,059,950500,1
"Block Group 2, Census Tract 9505, Umatilla County, Oregon",654,474,180,41,059,950500,2
"Block Group 3, Census Tract 9505, Umatilla County, Oregon",154,122,32,41,059,950500,3
"Block Group 2, Census Tract 9507, Umatilla County, Oregon",317,90,227,41,059,950700,2
"Block Group 1, Census Tract 9507, Umatilla County, Oregon",408,173,235,41,059,950700,1
"Block Group 3, Census Tract 9507, Umatilla County, Oregon",295,174,121,41,059,950700,3
"Block Group 2, Census Tract 9509, Umatilla County, Oregon",365,239,126,41,059,950900,2
"Block Group 3, Census Tract 9509, Umatilla County, Oregon",879,731,148,41,059,950900,3
"Block Group 1, Census Tract 9509, Umatilla County, Oregon",494,137,357,41,059,950900,1
"Block Group 1, Census Tract 9502, Umatilla County, Oregon",497,355,142,41,059,950200,1
"Block Group 3, Census Tract 9502, Umatilla County, Oregon",436,258,178,41,059,950200,3
"Block Group 5, Census Tract 9502, Umatilla County, Oregon",401,249,152,41,059,950200,5
"Block Group 4, Census Tract 9502, Umatilla County, Oregon",357,188,169,41,059,950200,4
"Block Group 2, Census Tract 9502, Umatilla County, Oregon",490,307,183,41,059,950200,2
"Block Group 6, Census Tract 9502, Umatilla County, Oregon",206,151,55,41,059,950200,6
"Block Group 1, Census Tract 9514, Umatilla County, Oregon",602,474,128,41,059,951400,1
"Block Group 2, Census Tract 108.02, Marion County, Oregon",534,430,104,41,047,010802,2
"Block Group 4, Census Tract 108.02, Marion County, Oregon",862,677,185,41,047,010802,4
"Block Group 4, Census Tract 18.01, Marion County, Oregon",522,362,160,41,047,001801,4
"Block Group 3, Census Tract 18.01, Marion County, Oregon",476,347,129,41,047,001801,3
"Block Group 2, Census Tract 18.01, Marion County, Oregon",765,168,597,41,047,001801,2
"Block Group 1, Census Tract 228, Clackamas County, Oregon",583,192,391,41,005,022800,1
"Block Group 3, Census Tract 228, Clackamas County, Oregon",279,227,52,41,005,022800,3
"Block Group 2, Census Tract 232.02, Clackamas County, Oregon",717,687,30,41,005,023202,2
"Block Group 2, Census Tract 302.02, Yamhill County, Oregon",353,191,162,41,071,030202,2
"Block Group 1, Census Tract 302.02, Yamhill County, Oregon",915,531,384,41,071,030202,1
"Block Group 2, Census Tract 9503, Baker County, Oregon",511,221,290,41,001,950300,2
"Block Group 3, Census Tract 9503, Baker County, Oregon",213,141,72,41,001,950300,3
"Block Group 3, Census Tract 9501, Baker County, Oregon",518,401,117,41,001,950100,3
"Block Group 1, Census Tract 9501, Baker County, Oregon",396,328,68,41,001,950100,1
"Block Group 3, Census Tract 9504, Baker County, Oregon",302,190,112,41,001,950400,3
"Block Group 1, Census Tract 9504, Baker County, Oregon",681,519,162,41,001,950400,1
"Block Group 1, Census Tract 9506, Baker County, Oregon",248,184,64,41,001,950600,1
"Block Group 3, Census Tract 9502, Baker County, Oregon",477,296,181,41,001,950200,3
"Block Group 2, Census Tract 9505, Baker County, Oregon",254,143,111,41,001,950500,2
"Block Group 1, Census Tract 9505, Baker County, Oregon",742,581,161,41,001,950500,1
"Block Group 1, Census Tract 3611, Josephine County, Oregon",1001,626,375,41,033,361100,1
"Block Group 3, Census Tract 3611, Josephine County, Oregon",884,484,400,41,033,361100,3
"Block Group 4, Census Tract 3613, Josephine County, Oregon",819,633,186,41,033,361300,4
"Block Group 2, Census Tract 16.04, Marion County, Oregon",523,157,366,41,047,001604,2
"Block Group 2, Census Tract 214, Clackamas County, Oregon",395,171,224,41,005,021400,2
"Block Group 3, Census Tract 214, Clackamas County, Oregon",400,163,237,41,005,021400,3
"Block Group 1, Census Tract 9718, Klamath County, Oregon",382,136,246,41,035,971800,1
"Block Group 2, Census Tract 9703, Klamath County, Oregon",212,203,9,41,035,970300,2
"Block Group 1, Census Tract 9703, Klamath County, Oregon",295,248,47,41,035,970300,1
"Block Group 3, Census Tract 9703, Klamath County, Oregon",403,389,14,41,035,970300,3
"Block Group 4, Census Tract 9703, Klamath County, Oregon",306,306,0,41,035,970300,4
"Block Group 2, Census Tract 9705, Klamath County, Oregon",247,226,21,41,035,970500,2
"Block Group 1, Census Tract 9705, Klamath County, Oregon",426,313,113,41,035,970500,1
"Block Group 3, Census Tract 9711, Klamath County, Oregon",553,387,166,41,035,971100,3
"Block Group 4, Census Tract 9711, Klamath County, Oregon",227,123,104,41,035,971100,4
"Block Group 1, Census Tract 9711, Klamath County, Oregon",311,116,195,41,035,971100,1
"Block Group 2, Census Tract 9711, Klamath County, Oregon",1049,741,308,41,035,971100,2
"Block Group 2, Census Tract 106, Marion County, Oregon",627,562,65,41,047,010600,2
"Block Group 3, Census Tract 106, Marion County, Oregon",291,206,85,41,047,010600,3
"Block Group 3, Census Tract 13, Marion County, Oregon",289,228,61,41,047,001300,3
"Block Group 1, Census Tract 13, Marion County, Oregon",825,509,316,41,047,001300,1
"Block Group 3, Census Tract 15.01, Marion County, Oregon",726,246,480,41,047,001501,3
"Block Group 1, Census Tract 15.01, Marion County, Oregon",473,365,108,41,047,001501,1
"Block Group 4, Census Tract 16.02, Marion County, Oregon",651,434,217,41,047,001602,4
"Block Group 2, Census Tract 16.02, Marion County, Oregon",941,73,868,41,047,001602,2
"Block Group 1, Census Tract 16.02, Marion County, Oregon",806,119,687,41,047,001602,1
"Block Group 3, Census Tract 18.02, Marion County, Oregon",381,296,85,41,047,001802,3
"Block Group 2, Census Tract 18.02, Marion County, Oregon",462,133,329,41,047,001802,2
"Block Group 1, Census Tract 23.01, Marion County, Oregon",948,588,360,41,047,002301,1
"Block Group 1, Census Tract 107.02, Marion County, Oregon",418,330,88,41,047,010702,1
"Block Group 2, Census Tract 107.02, Marion County, Oregon",933,820,113,41,047,010702,2
"Block Group 4, Census Tract 108.01, Marion County, Oregon",230,167,63,41,047,010801,4
"Block Group 5, Census Tract 108.01, Marion County, Oregon",639,444,195,41,047,010801,5
"Block Group 1, Census Tract 108.01, Marion County, Oregon",433,227,206,41,047,010801,1
"Block Group 2, Census Tract 108.01, Marion County, Oregon",345,216,129,41,047,010801,2
"Block Group 2, Census Tract 232.01, Clackamas County, Oregon",746,657,89,41,005,023201,2
"Block Group 1, Census Tract 232.01, Clackamas County, Oregon",740,714,26,41,005,023201,1
"Block Group 1, Census Tract 236, Clackamas County, Oregon",408,370,38,41,005,023600,1
"Block Group 3, Census Tract 243.02, Clackamas County, Oregon",761,715,46,41,005,024302,3
"Block Group 2, Census Tract 203.04, Clackamas County, Oregon",574,436,138,41,005,020304,2
"Block Group 1, Census Tract 203.04, Clackamas County, Oregon",711,694,17,41,005,020304,1
"Block Group 1, Census Tract 212, Clackamas County, Oregon",933,241,692,41,005,021200,1
"Block Group 1, Census Tract 224, Clackamas County, Oregon",399,171,228,41,005,022400,1
"Block Group 1, Census Tract 9707, Klamath County, Oregon",281,243,38,41,035,970700,1
"Block Group 2, Census Tract 9707, Klamath County, Oregon",590,420,170,41,035,970700,2
"Block Group 3, Census Tract 9717, Klamath County, Oregon",220,42,178,41,035,971700,3
"Block Group 2, Census Tract 9717, Klamath County, Oregon",459,279,180,41,035,971700,2
"Block Group 1, Census Tract 9710, Klamath County, Oregon",317,191,126,41,035,971000,1
"Block Group 1, Census Tract 9506, Umatilla County, Oregon",214,142,72,41,059,950600,1
"Block Group 3, Census Tract 9506, Umatilla County, Oregon",236,31,205,41,059,950600,3
"Block Group 6, Census Tract 9506, Umatilla County, Oregon",498,311,187,41,059,950600,6
"Block Group 4, Census Tract 9508, Umatilla County, Oregon",1058,970,88,41,059,950800,4
"Block Group 2, Census Tract 9508, Umatilla County, Oregon",325,169,156,41,059,950800,2
"Block Group 1, Census Tract 9508, Umatilla County, Oregon",381,297,84,41,059,950800,1
"Block Group 3, Census Tract 9508, Umatilla County, Oregon",266,212,54,41,059,950800,3
"Block Group 1, Census Tract 9510, Umatilla County, Oregon",314,252,62,41,059,951000,1
"Block Group 2, Census Tract 9510, Umatilla County, Oregon",871,449,422,41,059,951000,2
"Block Group 4, Census Tract 9510, Umatilla County, Oregon",312,164,148,41,059,951000,4
"Block Group 3, Census Tract 9510, Umatilla County, Oregon",505,292,213,41,059,951000,3
"Block Group 3, Census Tract 2.03, Jackson County, Oregon",561,95,466,41,029,000203,3
"Block Group 2, Census Tract 2.03, Jackson County, Oregon",637,283,354,41,029,000203,2
"Block Group 1, Census Tract 2.03, Jackson County, Oregon",411,91,320,41,029,000203,1
"Block Group 3, Census Tract 13.02, Jackson County, Oregon",1028,927,101,41,029,001302,3
"Block Group 5, Census Tract 13.02, Jackson County, Oregon",413,390,23,41,029,001302,5
"Block Group 1, Census Tract 13.02, Jackson County, Oregon",424,356,68,41,029,001302,1
"Block Group 4, Census Tract 22, Jackson County, Oregon",698,464,234,41,029,002200,4
"Block Group 2, Census Tract 22, Jackson County, Oregon",634,282,352,41,029,002200,2
"Block Group 3, Census Tract 22, Jackson County, Oregon",556,460,96,41,029,002200,3
"Block Group 1, Census Tract 30.01, Jackson County, Oregon",398,301,97,41,029,003001,1
"Block Group 3, Census Tract 6.01, Jackson County, Oregon",803,520,283,41,029,000601,3
"Block Group 1, Census Tract 6.01, Jackson County, Oregon",781,757,24,41,029,000601,1
"Block Group 2, Census Tract 12, Jackson County, Oregon",55,26,29,41,029,001200,2
"Block Group 1, Census Tract 12, Jackson County, Oregon",1479,856,623,41,029,001200,1
"Block Group 2, Census Tract 240, Clackamas County, Oregon",268,242,26,41,005,024000,2
"Block Group 2, Census Tract 218.02, Clackamas County, Oregon",1040,567,473,41,005,021802,2
"Block Group 5, Census Tract 9510, Umatilla County, Oregon",291,142,149,41,059,951000,5
"Block Group 2, Census Tract 9513, Umatilla County, Oregon",505,397,108,41,059,951300,2
"Block Group 4, Census Tract 9513, Umatilla County, Oregon",431,229,202,41,059,951300,4
"Block Group 1, Census Tract 9513, Umatilla County, Oregon",176,129,47,41,059,951300,1
"Block Group 1, Census Tract 9501, Umatilla County, Oregon",743,532,211,41,059,950100,1
"Block Group 3, Census Tract 9511, Umatilla County, Oregon",294,122,172,41,059,951100,3
"Block Group 4, Census Tract 9511, Umatilla County, Oregon",185,165,20,41,059,951100,4
"Block Group 5, Census Tract 9511, Umatilla County, Oregon",591,511,80,41,059,951100,5
"Block Group 5, Census Tract 9512, Umatilla County, Oregon",587,577,10,41,059,951200,5
"Block Group 2, Census Tract 9512, Umatilla County, Oregon",536,236,300,41,059,951200,2
"Block Group 3, Census Tract 9512, Umatilla County, Oregon",254,105,149,41,059,951200,3
"Block Group 6, Census Tract 9512, Umatilla County, Oregon",560,262,298,41,059,951200,6
"Block Group 1, Census Tract 9518, Lincoln County, Oregon",355,299,56,41,041,951800,1
"Block Group 2, Census Tract 9518, Lincoln County, Oregon",664,448,216,41,041,951800,2
"Block Group 1, Census Tract 9517, Lincoln County, Oregon",872,619,253,41,041,951700,1
"Block Group 1, Census Tract 204, Polk County, Oregon",549,354,195,41,053,020400,1
"Block Group 4, Census Tract 204, Polk County, Oregon",666,594,72,41,053,020400,4
"Block Group 2, Census Tract 204, Polk County, Oregon",640,511,129,41,053,020400,2
"Block Group 5, Census Tract 204, Polk County, Oregon",240,197,43,41,053,020400,5
"Block Group 2, Census Tract 201, Clackamas County, Oregon",369,327,42,41,005,020100,2
"Block Group 1, Census Tract 201, Clackamas County, Oregon",922,905,17,41,005,020100,1
"Block Group 1, Census Tract 203.02, Clackamas County, Oregon",536,210,326,41,005,020302,1
"Block Group 2, Census Tract 203.02, Clackamas County, Oregon",1177,905,272,41,005,020302,2
"Block Group 1, Census Tract 3, Jackson County, Oregon",1227,622,605,41,029,000300,1
"Block Group 2, Census Tract 3, Jackson County, Oregon",1306,632,674,41,029,000300,2
"Block Group 2, Census Tract 2.02, Jackson County, Oregon",457,114,343,41,029,000202,2
"Block Group 3, Census Tract 2.02, Jackson County, Oregon",445,127,318,41,029,000202,3
"Block Group 1, Census Tract 2.02, Jackson County, Oregon",531,212,319,41,029,000202,1
"Block Group 2, Census Tract 17, Jackson County, Oregon",1077,482,595,41,029,001700,2
"Block Group 3, Census Tract 17, Jackson County, Oregon",413,339,74,41,029,001700,3
"Block Group 2, Census Tract 19, Jackson County, Oregon",290,147,143,41,029,001900,2
"Block Group 1, Census Tract 1, Jackson County, Oregon",407,78,329,41,029,000100,1
"Block Group 4, Census Tract 224, Clackamas County, Oregon",225,101,124,41,005,022400,4
"Block Group 5, Census Tract 224, Clackamas County, Oregon",410,156,254,41,005,022400,5
"Block Group 2, Census Tract 237, Clackamas County, Oregon",256,163,93,41,005,023700,2
"Block Group 1, Census Tract 237, Clackamas County, Oregon",546,468,78,41,005,023700,1
"Block Group 4, Census Tract 800, Douglas County, Oregon",467,436,31,41,019,080000,4
"Block Group 5, Census Tract 800, Douglas County, Oregon",364,77,287,41,019,080000,5
"Block Group 3, Census Tract 209, Clackamas County, Oregon",848,284,564,41,005,020900,3
"Block Group 2, Census Tract 209, Clackamas County, Oregon",442,319,123,41,005,020900,2
"Block Group 3, Census Tract 216.02, Clackamas County, Oregon",931,560,371,41,005,021602,3
"Block Group 1, Census Tract 216.02, Clackamas County, Oregon",823,240,583,41,005,021602,1
"Block Group 2, Census Tract 219, Clackamas County, Oregon",466,265,201,41,005,021900,2
"Block Group 4, Census Tract 202, Clackamas County, Oregon",878,717,161,41,005,020200,4
"Block Group 2, Census Tract 202, Clackamas County, Oregon",508,486,22,41,005,020200,2
"Block Group 1, Census Tract 217, Clackamas County, Oregon",1080,962,118,41,005,021700,1
"Block Group 2, Census Tract 217, Clackamas County, Oregon",802,388,414,41,005,021700,2
"Block Group 2, Census Tract 9514, Umatilla County, Oregon",306,210,96,41,059,951400,2
"Block Group 3, Census Tract 9503, Umatilla County, Oregon",483,357,126,41,059,950300,3
"Block Group 2, Census Tract 9503, Umatilla County, Oregon",324,244,80,41,059,950300,2
"Block Group 5, Census Tract 9504, Umatilla County, Oregon",378,273,105,41,059,950400,5
"Block Group 6, Census Tract 9504, Umatilla County, Oregon",275,254,21,41,059,950400,6
"Block Group 1, Census Tract 9504, Umatilla County, Oregon",167,122,45,41,059,950400,1
"Block Group 3, Census Tract 9504, Umatilla County, Oregon",404,157,247,41,059,950400,3
"Block Group 4, Census Tract 9506, Umatilla County, Oregon",390,206,184,41,059,950600,4
"Block Group 2, Census Tract 9506, Umatilla County, Oregon",242,59,183,41,059,950600,2
"Block Group 2, Census Tract 312, Washington County, Oregon",260,0,260,41,067,031200,2
"Block Group 2, Census Tract 316.06, Washington County, Oregon",583,273,310,41,067,031606,2
"Block Group 1, Census Tract 316.06, Washington County, Oregon",825,538,287,41,067,031606,1
"Block Group 3, Census Tract 316.06, Washington County, Oregon",805,520,285,41,067,031606,3
"Block Group 1, Census Tract 316.13, Washington County, Oregon",543,418,125,41,067,031613,1
"Block Group 2, Census Tract 9704, Union County, Oregon",542,250,292,41,061,970400,2
"Block Group 1, Census Tract 9704, Union County, Oregon",362,344,18,41,061,970400,1
"Block Group 2, Census Tract 9704, Columbia County, Oregon",520,435,85,41,009,970400,2
"Block Group 1, Census Tract 9704, Columbia County, Oregon",410,339,71,41,009,970400,1
"Block Group 6, Census Tract 304.01, Linn County, Oregon",254,135,119,41,043,030401,6
"Block Group 1, Census Tract 304.01, Linn County, Oregon",599,502,97,41,043,030401,1
"Block Group 3, Census Tract 307, Linn County, Oregon",411,316,95,41,043,030700,3
"Block Group 4, Census Tract 307, Linn County, Oregon",618,415,203,41,043,030700,4
"Block Group 3, Census Tract 37.01, Multnomah County, Oregon",610,313,297,41,051,003701,3
"Block Group 3, Census Tract 317.03, Washington County, Oregon",750,567,183,41,067,031703,3
"Block Group 1, Census Tract 318.05, Washington County, Oregon",541,460,81,41,067,031805,1
"Block Group 4, Census Tract 318.05, Washington County, Oregon",511,458,53,41,067,031805,4
"Block Group 1, Census Tract 321.03, Washington County, Oregon",872,812,60,41,067,032103,1
"Block Group 2, Census Tract 321.03, Washington County, Oregon",1556,868,688,41,067,032103,2
"Block Group 3, Census Tract 326.03, Washington County, Oregon",591,449,142,41,067,032603,3
"Block Group 1, Census Tract 326.03, Washington County, Oregon",425,233,192,41,067,032603,1
"Block Group 1, Census Tract 244, Clackamas County, Oregon",1248,451,797,41,005,024400,1
"Block Group 3, Census Tract 244, Clackamas County, Oregon",1570,295,1275,41,005,024400,3
"Block Group 2, Census Tract 244, Clackamas County, Oregon",500,182,318,41,005,024400,2
"Block Group 2, Census Tract 21.02, Marion County, Oregon",293,195,98,41,047,002102,2
"Block Group 3, Census Tract 21.02, Marion County, Oregon",704,206,498,41,047,002102,3
"Block Group 4, Census Tract 21.02, Marion County, Oregon",764,489,275,41,047,002102,4
"Block Group 1, Census Tract 21.02, Marion County, Oregon",642,377,265,41,047,002102,1
"Block Group 2, Census Tract 23.03, Marion County, Oregon",763,605,158,41,047,002303,2
"Block Group 3, Census Tract 9503.04, Lincoln County, Oregon",690,354,336,41,041,950304,3
"Block Group 1, Census Tract 9503.03, Lincoln County, Oregon",464,363,101,41,041,950303,1
"Block Group 2, Census Tract 9503.03, Lincoln County, Oregon",278,206,72,41,041,950303,2
"Block Group 3, Census Tract 220, Clackamas County, Oregon",902,551,351,41,005,022000,3
"Block Group 4, Census Tract 228, Clackamas County, Oregon",319,263,56,41,005,022800,4
"Block Group 5, Census Tract 202, Clackamas County, Oregon",574,178,396,41,005,020200,5
"Block Group 2, Census Tract 67.01, Multnomah County, Oregon",621,281,340,41,051,006701,2
"Block Group 5, Census Tract 53, Polk County, Oregon",1110,1081,29,41,053,005300,5
"Block Group 2, Census Tract 203.04, Polk County, Oregon",579,103,476,41,053,020304,2
"Block Group 1, Census Tract 203.04, Polk County, Oregon",638,171,467,41,053,020304,1
"Block Group 2, Census Tract 203.03, Polk County, Oregon",615,263,352,41,053,020303,2
"Block Group 2, Census Tract 205, Polk County, Oregon",1168,1019,149,41,053,020500,2
"Block Group 3, Census Tract 96.05, Multnomah County, Oregon",797,323,474,41,051,009605,3
"Block Group 1, Census Tract 104.11, Multnomah County, Oregon",568,184,384,41,051,010411,1
"Block Group 2, Census Tract 64.03, Multnomah County, Oregon",948,476,472,41,051,006403,2
"Block Group 3, Census Tract 64.03, Multnomah County, Oregon",437,152,285,41,051,006403,3
"Block Group 1, Census Tract 104.10, Multnomah County, Oregon",633,139,494,41,051,010410,1
"Block Group 3, Census Tract 104.10, Multnomah County, Oregon",333,177,156,41,051,010410,3
"Block Group 1, Census Tract 9604, Tillamook County, Oregon",291,265,26,41,057,960400,1
"Block Group 3, Census Tract 9604, Tillamook County, Oregon",745,380,365,41,057,960400,3
"Block Group 3, Census Tract 9605, Tillamook County, Oregon",274,123,151,41,057,960500,3
"Block Group 1, Census Tract 9605, Tillamook County, Oregon",215,111,104,41,057,960500,1
"Block Group 2, Census Tract 9607, Tillamook County, Oregon",259,233,26,41,057,960700,2
"Block Group 1, Census Tract 305.01, Yamhill County, Oregon",535,441,94,41,071,030501,1
"Block Group 3, Census Tract 305.01, Yamhill County, Oregon",833,586,247,41,071,030501,3
"Block Group 1, Census Tract 307.02, Yamhill County, Oregon",745,453,292,41,071,030702,1
"Block Group 1, Census Tract 310, Yamhill County, Oregon",702,507,195,41,071,031000,1
"Block Group 3, Census Tract 302.01, Yamhill County, Oregon",376,209,167,41,071,030201,3
"Block Group 4, Census Tract 302.01, Yamhill County, Oregon",606,131,475,41,071,030201,4
"Block Group 2, Census Tract 302.01, Yamhill County, Oregon",547,213,334,41,071,030201,2
"Block Group 2, Census Tract 105.03, Marion County, Oregon",348,226,122,41,047,010503,2
"Block Group 3, Census Tract 105.03, Marion County, Oregon",708,534,174,41,047,010503,3
"Block Group 2, Census Tract 107.01, Marion County, Oregon",621,327,294,41,047,010701,2
"Block Group 5, Census Tract 107.01, Marion County, Oregon",692,472,220,41,047,010701,5
"Block Group 1, Census Tract 52.01, Polk County, Oregon",242,138,104,41,053,005201,1
"Block Group 3, Census Tract 52.01, Polk County, Oregon",1478,801,677,41,053,005201,3
"Block Group 1, Census Tract 202.04, Polk County, Oregon",443,367,76,41,053,020204,1
"Block Group 2, Census Tract 202.04, Polk County, Oregon",481,435,46,41,053,020204,2
"Block Group 1, Census Tract 51, Polk County, Oregon",394,165,229,41,053,005100,1
"Block Group 3, Census Tract 105.01, Marion County, Oregon",736,647,89,41,047,010501,3
"Block Group 1, Census Tract 105.01, Marion County, Oregon",575,564,11,41,047,010501,1
"Block Group 5, Census Tract 3.02, Multnomah County, Oregon",403,375,28,41,051,000302,5
"Block Group 2, Census Tract 3.02, Multnomah County, Oregon",580,493,87,41,051,000302,2
"Block Group 6, Census Tract 3.02, Multnomah County, Oregon",393,363,30,41,051,000302,6
"Block Group 4, Census Tract 3.02, Multnomah County, Oregon",488,430,58,41,051,000302,4
"Block Group 2, Census Tract 5.01, Multnomah County, Oregon",438,324,114,41,051,000501,2
"Block Group 4, Census Tract 5.01, Multnomah County, Oregon",395,276,119,41,051,000501,4
"Block Group 1, Census Tract 5.01, Multnomah County, Oregon",344,193,151,41,051,000501,1
"Block Group 3, Census Tract 5.01, Multnomah County, Oregon",518,303,215,41,051,000501,3
"Block Group 3, Census Tract 13.02, Multnomah County, Oregon",601,384,217,41,051,001302,3
"Block Group 2, Census Tract 13.02, Multnomah County, Oregon",526,270,256,41,051,001302,2
"Block Group 1, Census Tract 13.02, Multnomah County, Oregon",354,165,189,41,051,001302,1
"Block Group 1, Census Tract 24.01, Multnomah County, Oregon",533,485,48,41,051,002401,1
"Block Group 2, Census Tract 24.01, Multnomah County, Oregon",246,170,76,41,051,002401,2
"Block Group 4, Census Tract 9501, Crook County, Oregon",250,221,29,41,013,950100,4
"Block Group 3, Census Tract 9501, Crook County, Oregon",1634,989,645,41,013,950100,3
"Block Group 2, Census Tract 316.13, Washington County, Oregon",254,156,98,41,067,031613,2
"Block Group 4, Census Tract 316.13, Washington County, Oregon",1502,475,1027,41,067,031613,4
"Block Group 3, Census Tract 316.13, Washington County, Oregon",677,415,262,41,067,031613,3
"Block Group 2, Census Tract 318.07, Washington County, Oregon",722,650,72,41,067,031807,2
"Block Group 1, Census Tract 318.07, Washington County, Oregon",861,402,459,41,067,031807,1
"Block Group 5, Census Tract 324.04, Washington County, Oregon",588,314,274,41,067,032404,5
"Block Group 4, Census Tract 324.04, Washington County, Oregon",971,822,149,41,067,032404,4
"Block Group 2, Census Tract 324.04, Washington County, Oregon",446,357,89,41,067,032404,2
"Block Group 1, Census Tract 319.04, Washington County, Oregon",449,405,44,41,067,031904,1
"Block Group 1, Census Tract 309, Washington County, Oregon",894,272,622,41,067,030900,1
"Block Group 1, Census Tract 315.12, Washington County, Oregon",257,257,0,41,067,031512,1
"Block Group 2, Census Tract 315.12, Washington County, Oregon",1121,832,289,41,067,031512,2
"Block Group 2, Census Tract 9702, Morrow County, Oregon",229,154,75,41,049,970200,2
"Block Group 1, Census Tract 9702, Morrow County, Oregon",167,138,29,41,049,970200,1
"Block Group 6, Census Tract 9702, Morrow County, Oregon",179,138,41,41,049,970200,6
"Block Group 1, Census Tract 9701, Morrow County, Oregon",789,615,174,41,049,970100,1
"Block Group 3, Census Tract 9504, Hood River County, Oregon",607,523,84,41,027,950400,3
"Block Group 2, Census Tract 9602, Lake County, Oregon",226,222,4,41,037,960200,2
"Block Group 4, Census Tract 9602, Lake County, Oregon",316,178,138,41,037,960200,4
"Block Group 3, Census Tract 9602, Lake County, Oregon",336,199,137,41,037,960200,3
"Block Group 5, Census Tract 9602, Lake County, Oregon",404,250,154,41,037,960200,5
"Block Group 2, Census Tract 9601, Lake County, Oregon",441,242,199,41,037,960100,2
"Block Group 1, Census Tract 9601, Lake County, Oregon",954,533,421,41,037,960100,1
"Block Group 2, Census Tract 3.01, Multnomah County, Oregon",273,192,81,41,051,000301,2
"Block Group 3, Census Tract 2, Multnomah County, Oregon",726,437,289,41,051,000200,3
"Block Group 4, Census Tract 2, Multnomah County, Oregon",911,175,736,41,051,000200,4
"Block Group 2, Census Tract 4.02, Multnomah County, Oregon",345,268,77,41,051,000402,2
"Block Group 3, Census Tract 4.02, Multnomah County, Oregon",627,344,283,41,051,000402,3
"Block Group 1, Census Tract 11.02, Multnomah County, Oregon",676,290,386,41,051,001102,1
"Block Group 3, Census Tract 15, Multnomah County, Oregon",308,227,81,41,051,001500,3
"Block Group 2, Census Tract 15, Multnomah County, Oregon",469,269,200,41,051,001500,2
"Block Group 1, Census Tract 76, Multnomah County, Oregon",531,426,105,41,051,007600,1
"Block Group 2, Census Tract 76, Multnomah County, Oregon",813,417,396,41,051,007600,2
"Block Group 2, Census Tract 77, Multnomah County, Oregon",380,293,87,41,051,007700,2
"Block Group 2, Census Tract 81, Multnomah County, Oregon",673,321,352,41,051,008100,2
"Block Group 4, Census Tract 81, Multnomah County, Oregon",826,454,372,41,051,008100,4
"Block Group 1, Census Tract 9706, Malheur County, Oregon",331,165,166,41,045,970600,1
"Block Group 3, Census Tract 9706, Malheur County, Oregon",325,199,126,41,045,970600,3
"Block Group 2, Census Tract 303.02, Yamhill County, Oregon",435,389,46,41,071,030302,2
"Block Group 1, Census Tract 303.02, Yamhill County, Oregon",332,310,22,41,071,030302,1
"Block Group 1, Census Tract 301.02, Yamhill County, Oregon",368,328,40,41,071,030102,1
"Block Group 3, Census Tract 301.02, Yamhill County, Oregon",1138,760,378,41,071,030102,3
"Block Group 1, Census Tract 306.01, Yamhill County, Oregon",515,418,97,41,071,030601,1
"Block Group 2, Census Tract 306.01, Yamhill County, Oregon",673,441,232,41,071,030601,2
"Block Group 1, Census Tract 301.01, Yamhill County, Oregon",1133,811,322,41,071,030101,1
"Block Group 1, Census Tract 303.01, Yamhill County, Oregon",158,135,23,41,071,030301,1
"Block Group 2, Census Tract 303.01, Yamhill County, Oregon",1429,1271,158,41,071,030301,2
"Block Group 2, Census Tract 204.04, Clackamas County, Oregon",663,548,115,41,005,020404,2
"Block Group 1, Census Tract 204.04, Clackamas County, Oregon",776,703,73,41,005,020404,1
"Block Group 3, Census Tract 309, Washington County, Oregon",679,209,470,41,067,030900,3
"Block Group 2, Census Tract 309, Washington County, Oregon",725,288,437,41,067,030900,2
"Block Group 4, Census Tract 9603.02, Jefferson County, Oregon",776,537,239,41,031,960302,4
"Block Group 3, Census Tract 9603.02, Jefferson County, Oregon",258,199,59,41,031,960302,3
"Block Group 1, Census Tract 230.01, Clackamas County, Oregon",855,765,90,41,005,023001,1
"Block Group 5, Census Tract 9501, Crook County, Oregon",383,261,122,41,013,950100,5
"Block Group 2, Census Tract 9502, Crook County, Oregon",476,446,30,41,013,950200,2
"Block Group 4, Census Tract 9502, Crook County, Oregon",391,343,48,41,013,950200,4
"Block Group 2, Census Tract 9503, Crook County, Oregon",541,388,153,41,013,950300,2
"Block Group 4, Census Tract 9503, Crook County, Oregon",257,170,87,41,013,950300,4
"Block Group 5, Census Tract 9503, Crook County, Oregon",965,810,155,41,013,950300,5
"Block Group 2, Census Tract 9501, Sherman County, Oregon",375,279,96,41,055,950100,2
"Block Group 1, Census Tract 9501, Sherman County, Oregon",373,204,169,41,055,950100,1
"Block Group 3, Census Tract 9702, Wasco County, Oregon",493,152,341,41,065,970200,3
"Block Group 2, Census Tract 9705, Wasco County, Oregon",647,373,274,41,065,970500,2
"Block Group 3, Census Tract 9705, Wasco County, Oregon",458,242,216,41,065,970500,3
"Block Group 2, Census Tract 9707, Wasco County, Oregon",437,348,89,41,065,970700,2
"Block Group 1, Census Tract 39, Lane County, Oregon",456,0,456,41,039,003900,1
"Block Group 3, Census Tract 39, Lane County, Oregon",511,28,483,41,039,003900,3
"Block Group 2, Census Tract 11, Coos County, Oregon",227,137,90,41,011,001100,2
"Block Group 6, Census Tract 11, Coos County, Oregon",388,189,199,41,011,001100,6
"Block Group 3, Census Tract 11, Coos County, Oregon",345,226,119,41,011,001100,3
"Block Group 5, Census Tract 11, Coos County, Oregon",350,254,96,41,011,001100,5
"Block Group 2, Census Tract 6, Coos County, Oregon",274,219,55,41,011,000600,2
"Block Group 1, Census Tract 6, Coos County, Oregon",352,255,97,41,011,000600,1
"Block Group 2, Census Tract 3, Coos County, Oregon",279,171,108,41,011,000300,2
"Block Group 1, Census Tract 63, Multnomah County, Oregon",607,543,64,41,051,006300,1
"Block Group 2, Census Tract 64.02, Multnomah County, Oregon",1003,897,106,41,051,006402,2
"Block Group 3, Census Tract 70, Multnomah County, Oregon",330,314,16,41,051,007000,3
"Block Group 2, Census Tract 70, Multnomah County, Oregon",769,719,50,41,051,007000,2
"Block Group 2, Census Tract 72.01, Multnomah County, Oregon",727,451,276,41,051,007201,2
"Block Group 3, Census Tract 38.02, Multnomah County, Oregon",416,313,103,41,051,003802,3
"Block Group 3, Census Tract 9602.02, Jefferson County, Oregon",786,457,329,41,031,960202,3
"Block Group 2, Census Tract 9602.02, Jefferson County, Oregon",843,564,279,41,031,960202,2
"Block Group 2, Census Tract 9602.01, Jefferson County, Oregon",533,216,317,41,031,960201,2
"Block Group 1, Census Tract 9602.01, Jefferson County, Oregon",784,396,388,41,031,960201,1
"Block Group 2, Census Tract 9603.01, Jefferson County, Oregon",453,410,43,41,031,960301,2
"Block Group 3, Census Tract 9603.01, Jefferson County, Oregon",826,702,124,41,031,960301,3
"Block Group 1, Census Tract 9603.01, Jefferson County, Oregon",362,340,22,41,031,960301,1
"Block Group 2, Census Tract 2.02, Benton County, Oregon",1789,877,912,41,003,000202,2
"Block Group 1, Census Tract 2.02, Benton County, Oregon",498,468,30,41,003,000202,1
"Block Group 2, Census Tract 107.02, Benton County, Oregon",0,0,0,41,003,010702,2
"Block Group 3, Census Tract 107.02, Benton County, Oregon",587,38,549,41,003,010702,3
"Block Group 1, Census Tract 107.02, Benton County, Oregon",514,148,366,41,003,010702,1
"Block Group 5, Census Tract 9706, Malheur County, Oregon",101,63,38,41,045,970600,5
"Block Group 2, Census Tract 9706, Malheur County, Oregon",411,229,182,41,045,970600,2
"Block Group 4, Census Tract 9706, Malheur County, Oregon",343,219,124,41,045,970600,4
"Block Group 1, Census Tract 9702, Malheur County, Oregon",380,332,48,41,045,970200,1
"Block Group 3, Census Tract 9702, Malheur County, Oregon",395,372,23,41,045,970200,3
"Block Group 4, Census Tract 9702, Malheur County, Oregon",669,483,186,41,045,970200,4
"Block Group 2, Census Tract 9702, Malheur County, Oregon",303,192,111,41,045,970200,2
"Block Group 1, Census Tract 9705, Malheur County, Oregon",287,182,105,41,045,970500,1
"Block Group 6, Census Tract 9705, Malheur County, Oregon",261,88,173,41,045,970500,6
"Block Group 4, Census Tract 9705, Malheur County, Oregon",282,141,141,41,045,970500,4
"Block Group 5, Census Tract 9705, Malheur County, Oregon",270,165,105,41,045,970500,5
"Block Group 3, Census Tract 9705, Malheur County, Oregon",262,189,73,41,045,970500,3
"Block Group 2, Census Tract 9705, Malheur County, Oregon",342,278,64,41,045,970500,2
"Block Group 2, Census Tract 1, Multnomah County, Oregon",550,505,45,41,051,000100,2
"Block Group 2, Census Tract 6.02, Multnomah County, Oregon",884,660,224,41,051,000602,2
"Block Group 3, Census Tract 6.02, Multnomah County, Oregon",516,381,135,41,051,000602,3
"Block Group 1, Census Tract 6.02, Multnomah County, Oregon",283,114,169,41,051,000602,1
"Block Group 4, Census Tract 8.01, Multnomah County, Oregon",462,223,239,41,051,000801,4
"Block Group 2, Census Tract 74, Multnomah County, Oregon",929,401,528,41,051,007400,2
"Block Group 1, Census Tract 7.01, Multnomah County, Oregon",637,480,157,41,051,000701,1
"Block Group 2, Census Tract 7.01, Multnomah County, Oregon",359,278,81,41,051,000701,2
"Block Group 2, Census Tract 16.02, Multnomah County, Oregon",421,293,128,41,051,001602,2
"Block Group 3, Census Tract 16.02, Multnomah County, Oregon",603,386,217,41,051,001602,3
"Block Group 4, Census Tract 16.02, Multnomah County, Oregon",328,241,87,41,051,001602,4
"Block Group 1, Census Tract 65.01, Multnomah County, Oregon",942,817,125,41,051,006501,1
"Block Group 1, Census Tract 79, Multnomah County, Oregon",621,162,459,41,051,007900,1
"Block Group 2, Census Tract 82.02, Multnomah County, Oregon",1049,525,524,41,051,008202,2
"Block Group 1, Census Tract 82.02, Multnomah County, Oregon",1556,459,1097,41,051,008202,1
"Block Group 2, Census Tract 83.02, Multnomah County, Oregon",830,432,398,41,051,008302,2
"Block Group 2, Census Tract 93.02, Multnomah County, Oregon",591,327,264,41,051,009302,2
"Block Group 2, Census Tract 97.01, Multnomah County, Oregon",482,339,143,41,051,009701,2
"Block Group 3, Census Tract 97.01, Multnomah County, Oregon",563,446,117,41,051,009701,3
"Block Group 2, Census Tract 103.03, Multnomah County, Oregon",831,533,298,41,051,010303,2
"Block Group 7, Census Tract 1, Multnomah County, Oregon",497,272,225,41,051,000100,7
"Block Group 6, Census Tract 1, Multnomah County, Oregon",408,254,154,41,051,000100,6
"Block Group 5, Census Tract 1, Multnomah County, Oregon",355,177,178,41,051,000100,5
"Block Group 1, Census Tract 1, Multnomah County, Oregon",346,309,37,41,051,000100,1
"Block Group 2, Census Tract 24.04, Lane County, Oregon",845,467,378,41,039,002404,2
"Block Group 1, Census Tract 11.02, Benton County, Oregon",328,157,171,41,003,001102,1
"Block Group 2, Census Tract 11.02, Benton County, Oregon",655,138,517,41,003,001102,2
"Block Group 3, Census Tract 104, Benton County, Oregon",956,671,285,41,003,010400,3
"Block Group 1, Census Tract 104, Benton County, Oregon",348,278,70,41,003,010400,1
"Block Group 2, Census Tract 104, Benton County, Oregon",253,216,37,41,003,010400,2
"Block Group 3, Census Tract 101, Benton County, Oregon",969,941,28,41,003,010100,3
"Block Group 1, Census Tract 101, Benton County, Oregon",313,271,42,41,003,010100,1
"Block Group 2, Census Tract 101, Benton County, Oregon",898,861,37,41,003,010100,2
"Block Group 4, Census Tract 101, Benton County, Oregon",749,650,99,41,003,010100,4
"Block Group 5, Census Tract 101, Benton County, Oregon",597,597,0,41,003,010100,5
"Block Group 4, Census Tract 4, Benton County, Oregon",441,374,67,41,003,000400,4
"Block Group 1, Census Tract 4, Benton County, Oregon",1092,528,564,41,003,000400,1
"Block Group 2, Census Tract 4, Benton County, Oregon",1180,915,265,41,003,000400,2
"Block Group 3, Census Tract 4, Benton County, Oregon",725,414,311,41,003,000400,3
"Block Group 1, Census Tract 1, Benton County, Oregon",480,154,326,41,003,000100,1
"Block Group 3, Census Tract 1, Benton County, Oregon",553,383,170,41,003,000100,3
"Block Group 3, Census Tract 47, Lane County, Oregon",458,266,192,41,039,004700,3
"Block Group 4, Census Tract 47, Lane County, Oregon",589,161,428,41,039,004700,4
"Block Group 1, Census Tract 47, Lane County, Oregon",314,144,170,41,039,004700,1
"Block Group 3, Census Tract 50, Lane County, Oregon",530,389,141,41,039,005000,3
"Block Group 1, Census Tract 50, Lane County, Oregon",464,255,209,41,039,005000,1
"Block Group 4, Census Tract 44.03, Lane County, Oregon",592,396,196,41,039,004403,4
"Block Group 1, Census Tract 44.03, Lane County, Oregon",471,94,377,41,039,004403,1
"Block Group 2, Census Tract 44.03, Lane County, Oregon",918,148,770,41,039,004403,2
"Block Group 1, Census Tract 48, Lane County, Oregon",921,122,799,41,039,004800,1
"Block Group 3, Census Tract 48, Lane County, Oregon",630,16,614,41,039,004800,3
"Block Group 1, Census Tract 9.03, Lane County, Oregon",231,174,57,41,039,000903,1
"Block Group 3, Census Tract 9.03, Lane County, Oregon",633,405,228,41,039,000903,3
"Block Group 2, Census Tract 13.02, Lane County, Oregon",807,439,368,41,039,001302,2
"Block Group 1, Census Tract 214, Clackamas County, Oregon",1260,1204,56,41,005,021400,1
"Block Group 1, Census Tract 220, Clackamas County, Oregon",685,500,185,41,005,022000,1
"Block Group 2, Census Tract 220, Clackamas County, Oregon",930,791,139,41,005,022000,2
"Block Group 1, Census Tract 231, Clackamas County, Oregon",893,837,56,41,005,023100,1
"Block Group 2, Census Tract 231, Clackamas County, Oregon",566,506,60,41,005,023100,2
"Block Group 3, Census Tract 231, Clackamas County, Oregon",912,778,134,41,005,023100,3
"Block Group 2, Census Tract 233, Clackamas County, Oregon",528,465,63,41,005,023300,2
"Block Group 1, Census Tract 233, Clackamas County, Oregon",817,763,54,41,005,023300,1
"Block Group 3, Census Tract 233, Clackamas County, Oregon",512,456,56,41,005,023300,3
"Block Group 1, Census Tract 3607.02, Josephine County, Oregon",1506,762,744,41,033,360702,1
"Block Group 2, Census Tract 3607.02, Josephine County, Oregon",366,138,228,41,033,360702,2
"Block Group 3, Census Tract 3607.02, Josephine County, Oregon",877,362,515,41,033,360702,3
"Block Group 3, Census Tract 3610, Josephine County, Oregon",548,481,67,41,033,361000,3
"Block Group 4, Census Tract 3610, Josephine County, Oregon",543,465,78,41,033,361000,4
"Block Group 2, Census Tract 3610, Josephine County, Oregon",528,428,100,41,033,361000,2
"Block Group 1, Census Tract 3616, Josephine County, Oregon",515,224,291,41,033,361600,1
"Block Group 7, Census Tract 3616, Josephine County, Oregon",591,462,129,41,033,361600,7
"Block Group 5, Census Tract 3616, Josephine County, Oregon",222,207,15,41,033,361600,5
"Block Group 2, Census Tract 3616, Josephine County, Oregon",700,407,293,41,033,361600,2
"Block Group 3, Census Tract 108, Benton County, Oregon",722,419,303,41,003,010800,3
"Block Group 1, Census Tract 108, Benton County, Oregon",278,102,176,41,003,010800,1
"Block Group 2, Census Tract 108, Benton County, Oregon",391,257,134,41,003,010800,2
"Block Group 4, Census Tract 106, Benton County, Oregon",59,0,59,41,003,010600,4
"Block Group 3, Census Tract 106, Benton County, Oregon",503,25,478,41,003,010600,3
"Block Group 1, Census Tract 106, Benton County, Oregon",823,235,588,41,003,010600,1
"Block Group 5, Census Tract 104, Marion County, Oregon",316,186,130,41,047,010400,5
"Block Group 1, Census Tract 9602, Harney County, Oregon",444,330,114,41,025,960200,1
"Block Group 4, Census Tract 9601, Harney County, Oregon",677,461,216,41,025,960100,4
"Block Group 3, Census Tract 9601, Harney County, Oregon",489,406,83,41,025,960100,3
"Block Group 5, Census Tract 9601, Harney County, Oregon",290,213,77,41,025,960100,5
"Block Group 2, Census Tract 314.02, Washington County, Oregon",627,0,627,41,067,031402,2
"Block Group 3, Census Tract 19.04, Lane County, Oregon",493,493,0,41,039,001904,3
"Block Group 1, Census Tract 29.03, Lane County, Oregon",535,335,200,41,039,002903,1
"Block Group 2, Census Tract 23.01, Lane County, Oregon",431,318,113,41,039,002301,2
"Block Group 3, Census Tract 45.01, Lane County, Oregon",528,95,433,41,039,004501,3
"Block Group 1, Census Tract 45.01, Lane County, Oregon",483,121,362,41,039,004501,1
"Block Group 4, Census Tract 3.01, Multnomah County, Oregon",513,63,450,41,051,000301,4
"Block Group 1, Census Tract 99.04, Multnomah County, Oregon",571,287,284,41,051,009904,1
"Block Group 3, Census Tract 99.04, Multnomah County, Oregon",385,302,83,41,051,009904,3
"Block Group 2, Census Tract 106, Multnomah County, Oregon",1266,288,978,41,051,010600,2
"Block Group 3, Census Tract 106, Multnomah County, Oregon",329,0,329,41,051,010600,3
"Block Group 1, Census Tract 23.03, Multnomah County, Oregon",423,73,350,41,051,002303,1
"Block Group 1, Census Tract 22.03, Multnomah County, Oregon",565,145,420,41,051,002203,1
"Block Group 2, Census Tract 22.03, Multnomah County, Oregon",492,254,238,41,051,002203,2
"Block Group 4, Census Tract 22.03, Multnomah County, Oregon",458,143,315,41,051,002203,4
"Block Group 3, Census Tract 65.01, Multnomah County, Oregon",640,586,54,41,051,006501,3
"Block Group 3, Census Tract 307.02, Yamhill County, Oregon",1140,830,310,41,071,030702,3
"Block Group 3, Census Tract 308.01, Yamhill County, Oregon",738,331,407,41,071,030801,3
"Block Group 4, Census Tract 35, Lane County, Oregon",499,462,37,41,039,003500,4
"Block Group 1, Census Tract 24.04, Lane County, Oregon",802,579,223,41,039,002404,1
"Block Group 1, Census Tract 28, Lane County, Oregon",894,297,597,41,039,002800,1
"Block Group 2, Census Tract 16, Lane County, Oregon",478,372,106,41,039,001600,2
"Block Group 3, Census Tract 16, Lane County, Oregon",411,353,58,41,039,001600,3
"Block Group 1, Census Tract 16, Lane County, Oregon",228,200,28,41,039,001600,1
"Block Group 4, Census Tract 16, Lane County, Oregon",381,346,35,41,039,001600,4
"Block Group 1, Census Tract 21.01, Lane County, Oregon",483,366,117,41,039,002101,1
"Block Group 3, Census Tract 99.03, Multnomah County, Oregon",763,631,132,41,051,009903,3
"Block Group 2, Census Tract 302, Washington County, Oregon",529,498,31,41,067,030200,2
"Block Group 3, Census Tract 302, Washington County, Oregon",922,486,436,41,067,030200,3
"Block Group 4, Census Tract 308.01, Washington County, Oregon",724,88,636,41,067,030801,4
"Block Group 3, Census Tract 308.01, Washington County, Oregon",758,310,448,41,067,030801,3
"Block Group 2, Census Tract 316.11, Washington County, Oregon",1254,498,756,41,067,031611,2
"Block Group 3, Census Tract 316.11, Washington County, Oregon",572,302,270,41,067,031611,3
"Block Group 6, Census Tract 17.01, Multnomah County, Oregon",371,246,125,41,051,001701,6
"Block Group 1, Census Tract 9707, Columbia County, Oregon",383,249,134,41,009,970700,1
"Block Group 4, Census Tract 9707, Columbia County, Oregon",607,358,249,41,009,970700,4
"Block Group 3, Census Tract 9707, Columbia County, Oregon",399,236,163,41,009,970700,3
"Block Group 1, Census Tract 9710, Columbia County, Oregon",623,262,361,41,009,971000,1
"Block Group 2, Census Tract 9710, Columbia County, Oregon",725,653,72,41,009,971000,2
"Block Group 3, Census Tract 9710, Columbia County, Oregon",559,490,69,41,009,971000,3
"Block Group 3, Census Tract 9705, Columbia County, Oregon",380,380,0,41,009,970500,3
"Block Group 4, Census Tract 9705, Columbia County, Oregon",326,236,90,41,009,970500,4
"Block Group 1, Census Tract 9705, Columbia County, Oregon",1337,1092,245,41,009,970500,1
"Block Group 2, Census Tract 9705, Columbia County, Oregon",535,470,65,41,009,970500,2
"Block Group 2, Census Tract 9711, Columbia County, Oregon",470,405,65,41,009,971100,2
"Block Group 3, Census Tract 9711, Columbia County, Oregon",504,450,54,41,009,971100,3
"Block Group 1, Census Tract 9711, Columbia County, Oregon",359,325,34,41,009,971100,1
"Block Group 1, Census Tract 9706, Columbia County, Oregon",723,683,40,41,009,970600,1
"Block Group 3, Census Tract 9706, Columbia County, Oregon",397,397,0,41,009,970600,3
"Block Group 2, Census Tract 9709, Columbia County, Oregon",409,228,181,41,009,970900,2
"Block Group 1, Census Tract 9709, Columbia County, Oregon",425,364,61,41,009,970900,1
"Block Group 1, Census Tract 9504, Crook County, Oregon",1585,1369,216,41,013,950400,1
"Block Group 2, Census Tract 9504, Crook County, Oregon",231,182,49,41,013,950400,2
"Block Group 2, Census Tract 53, Lane County, Oregon",718,606,112,41,039,005300,2
"Block Group 1, Census Tract 53, Lane County, Oregon",316,217,99,41,039,005300,1
"Block Group 3, Census Tract 11.01, Lane County, Oregon",1003,884,119,41,039,001101,3
"Block Group 1, Census Tract 11.01, Lane County, Oregon",668,616,52,41,039,001101,1
"Block Group 3, Census Tract 11.02, Lane County, Oregon",500,400,100,41,039,001102,3
"Block Group 1, Census Tract 11.02, Lane County, Oregon",326,315,11,41,039,001102,1
"Block Group 2, Census Tract 14, Lane County, Oregon",340,238,102,41,039,001400,2
"Block Group 2, Census Tract 3608, Josephine County, Oregon",460,425,35,41,033,360800,2
"Block Group 3, Census Tract 3608, Josephine County, Oregon",1114,844,270,41,033,360800,3
"Block Group 2, Census Tract 3605, Josephine County, Oregon",374,208,166,41,033,360500,2
"Block Group 4, Census Tract 3605, Josephine County, Oregon",716,305,411,41,033,360500,4
"Block Group 1, Census Tract 3615, Josephine County, Oregon",1072,863,209,41,033,361500,1
"Block Group 1, Census Tract 9702, Klamath County, Oregon",504,415,89,41,035,970200,1
"Block Group 2, Census Tract 9702, Klamath County, Oregon",466,454,12,41,035,970200,2
"Block Group 4, Census Tract 9702, Klamath County, Oregon",456,366,90,41,035,970200,4
"Block Group 1, Census Tract 105.02, Marion County, Oregon",1187,771,416,41,047,010502,1
"Block Group 3, Census Tract 105.02, Marion County, Oregon",216,124,92,41,047,010502,3
"Block Group 3, Census Tract 17.02, Marion County, Oregon",661,241,420,41,047,001702,3
"Block Group 1, Census Tract 17.02, Marion County, Oregon",474,356,118,41,047,001702,1
"Block Group 3, Census Tract 6, Marion County, Oregon",712,353,359,41,047,000600,3
"Block Group 1, Census Tract 6, Marion County, Oregon",624,417,207,41,047,000600,1
"Block Group 4, Census Tract 16.04, Marion County, Oregon",797,643,154,41,047,001604,4
"Block Group 1, Census Tract 17.01, Marion County, Oregon",696,25,671,41,047,001701,1
"Block Group 3, Census Tract 17.01, Marion County, Oregon",795,337,458,41,047,001701,3
"Block Group 2, Census Tract 17.03, Marion County, Oregon",533,469,64,41,047,001703,2
"Block Group 3, Census Tract 17.03, Marion County, Oregon",538,418,120,41,047,001703,3
"Block Group 1, Census Tract 24, Marion County, Oregon",569,510,59,41,047,002400,1
"Block Group 4, Census Tract 103.04, Marion County, Oregon",277,157,120,41,047,010304,4
"Block Group 2, Census Tract 103.04, Marion County, Oregon",782,627,155,41,047,010304,2
"Block Group 3, Census Tract 103.04, Marion County, Oregon",259,124,135,41,047,010304,3
"Block Group 1, Census Tract 328, Washington County, Oregon",432,335,97,41,067,032800,1
"Block Group 2, Census Tract 308.03, Washington County, Oregon",576,408,168,41,067,030803,2
"Block Group 3, Census Tract 308.03, Washington County, Oregon",663,625,38,41,067,030803,3
"Block Group 1, Census Tract 308.03, Washington County, Oregon",857,194,663,41,067,030803,1
"Block Group 2, Census Tract 303, Washington County, Oregon",428,326,102,41,067,030300,2
"Block Group 4, Census Tract 303, Washington County, Oregon",572,395,177,41,067,030300,4
"Block Group 1, Census Tract 303, Washington County, Oregon",560,390,170,41,067,030300,1
"Block Group 3, Census Tract 303, Washington County, Oregon",303,239,64,41,067,030300,3
"Block Group 5, Census Tract 310.03, Washington County, Oregon",706,476,230,41,067,031003,5
"Block Group 4, Census Tract 310.03, Washington County, Oregon",1094,829,265,41,067,031003,4
"Block Group 1, Census Tract 310.03, Washington County, Oregon",591,222,369,41,067,031003,1
"Block Group 2, Census Tract 9701, Morrow County, Oregon",569,474,95,41,049,970100,2
"Block Group 3, Census Tract 9701, Morrow County, Oregon",337,175,162,41,049,970100,3
"Block Group 5, Census Tract 9701, Morrow County, Oregon",570,491,79,41,049,970100,5
"Block Group 1, Census Tract 9512, Clatsop County, Oregon",306,270,36,41,007,951200,1
"Block Group 2, Census Tract 105.01, Marion County, Oregon",299,249,50,41,047,010501,2
"Block Group 1, Census Tract 4, Marion County, Oregon",807,267,540,41,047,000400,1
"Block Group 2, Census Tract 4, Marion County, Oregon",590,125,465,41,047,000400,2
"Block Group 2, Census Tract 10, Marion County, Oregon",624,105,519,41,047,001000,2
"Block Group 3, Census Tract 10, Marion County, Oregon",641,382,259,41,047,001000,3
"Block Group 1, Census Tract 17, Lane County, Oregon",713,479,234,41,039,001700,1
"Block Group 3, Census Tract 17, Lane County, Oregon",444,402,42,41,039,001700,3
"Block Group 4, Census Tract 17, Lane County, Oregon",648,588,60,41,039,001700,4
"Block Group 1, Census Tract 24.01, Lane County, Oregon",326,293,33,41,039,002401,1
"Block Group 1, Census Tract 29.02, Lane County, Oregon",1123,391,732,41,039,002902,1
"Block Group 2, Census Tract 30, Lane County, Oregon",1110,549,561,41,039,003000,2
"Block Group 3, Census Tract 310.03, Washington County, Oregon",264,205,59,41,067,031003,3
"Block Group 2, Census Tract 310.06, Washington County, Oregon",355,248,107,41,067,031006,2
"Block Group 1, Census Tract 310.06, Washington County, Oregon",1002,379,623,41,067,031006,1
"Block Group 4, Census Tract 310.06, Washington County, Oregon",1048,222,826,41,067,031006,4
"Block Group 2, Census Tract 317.06, Washington County, Oregon",402,191,211,41,067,031706,2
"Block Group 3, Census Tract 317.06, Washington County, Oregon",471,333,138,41,067,031706,3
"Block Group 1, Census Tract 316.10, Washington County, Oregon",327,302,25,41,067,031610,1
"Block Group 4, Census Tract 316.10, Washington County, Oregon",1140,826,314,41,067,031610,4
"Block Group 3, Census Tract 316.10, Washington County, Oregon",237,108,129,41,067,031610,3
"Block Group 3, Census Tract 320.01, Washington County, Oregon",377,343,34,41,067,032001,3
"Block Group 3, Census Tract 9512, Clatsop County, Oregon",458,368,90,41,007,951200,3
"Block Group 1, Census Tract 9513, Clatsop County, Oregon",595,512,83,41,007,951300,1
"Block Group 1, Census Tract 9505, Clatsop County, Oregon",506,329,177,41,007,950500,1
"Block Group 2, Census Tract 9502, Clatsop County, Oregon",372,89,283,41,007,950200,2
"Block Group 1, Census Tract 9502, Clatsop County, Oregon",562,401,161,41,007,950200,1
"Block Group 3, Census Tract 9502, Clatsop County, Oregon",553,324,229,41,007,950200,3
"Block Group 1, Census Tract 9503, Clatsop County, Oregon",343,186,157,41,007,950300,1
"Block Group 4, Census Tract 9503, Clatsop County, Oregon",277,201,76,41,007,950300,4
"Block Group 1, Census Tract 9506, Clatsop County, Oregon",483,359,124,41,007,950600,1
"Block Group 3, Census Tract 9506, Clatsop County, Oregon",206,143,63,41,007,950600,3
"Block Group 1, Census Tract 9509, Clatsop County, Oregon",378,198,180,41,007,950900,1
"Block Group 2, Census Tract 9509, Clatsop County, Oregon",414,217,197,41,007,950900,2
"Block Group 3, Census Tract 9509, Clatsop County, Oregon",411,189,222,41,007,950900,3
"Block Group 4, Census Tract 9509, Clatsop County, Oregon",211,53,158,41,007,950900,4
"Block Group 2, Census Tract 5.02, Multnomah County, Oregon",271,198,73,41,051,000502,2
"Block Group 5, Census Tract 5.02, Multnomah County, Oregon",497,273,224,41,051,000502,5
"Block Group 1, Census Tract 5.02, Multnomah County, Oregon",360,200,160,41,051,000502,1
"Block Group 3, Census Tract 8.02, Multnomah County, Oregon",558,289,269,41,051,000802,3
"Block Group 4, Census Tract 8.02, Multnomah County, Oregon",759,180,579,41,051,000802,4
"Block Group 2, Census Tract 8.02, Multnomah County, Oregon",358,180,178,41,051,000802,2
"Block Group 4, Census Tract 10, Multnomah County, Oregon",413,141,272,41,051,001000,4
"Block Group 3, Census Tract 10, Multnomah County, Oregon",564,189,375,41,051,001000,3
"Block Group 2, Census Tract 10, Multnomah County, Oregon",610,390,220,41,051,001000,2
"Block Group 1, Census Tract 11.01, Multnomah County, Oregon",675,0,675,41,051,001101,1
"Block Group 2, Census Tract 12.01, Multnomah County, Oregon",727,157,570,41,051,001201,2
"Block Group 4, Census Tract 12.01, Multnomah County, Oregon",1127,61,1066,41,051,001201,4
"Block Group 2, Census Tract 230.01, Clackamas County, Oregon",439,407,32,41,005,023001,2
"Block Group 1, Census Tract 234.03, Clackamas County, Oregon",1994,1384,610,41,005,023403,1
"Block Group 3, Census Tract 234.04, Clackamas County, Oregon",464,350,114,41,005,023404,3
"Block Group 4, Census Tract 234.04, Clackamas County, Oregon",496,358,138,41,005,023404,4
"Block Group 1, Census Tract 234.04, Clackamas County, Oregon",584,469,115,41,005,023404,1
"Block Group 2, Census Tract 234.04, Clackamas County, Oregon",952,758,194,41,005,023404,2
"Block Group 2, Census Tract 239.02, Clackamas County, Oregon",529,380,149,41,005,023902,2
"Block Group 1, Census Tract 4.05, Jackson County, Oregon",720,335,385,41,029,000405,1
"Block Group 4, Census Tract 10.01, Jackson County, Oregon",715,536,179,41,029,001001,4
"Block Group 3, Census Tract 321.03, Washington County, Oregon",1309,1109,200,41,067,032103,3
"Block Group 3, Census Tract 304.01, Washington County, Oregon",665,353,312,41,067,030401,3
"Block Group 3, Census Tract 304.02, Washington County, Oregon",751,384,367,41,067,030402,3
"Block Group 1, Census Tract 10, Marion County, Oregon",349,124,225,41,047,001000,1
"Block Group 1, Census Tract 103.03, Marion County, Oregon",646,522,124,41,047,010303,1
"Block Group 2, Census Tract 103.03, Marion County, Oregon",583,412,171,41,047,010303,2
"Block Group 1, Census Tract 211, Clackamas County, Oregon",408,219,189,41,005,021100,1
"Block Group 3, Census Tract 211, Clackamas County, Oregon",558,512,46,41,005,021100,3
"Block Group 2, Census Tract 211, Clackamas County, Oregon",582,379,203,41,005,021100,2
"Block Group 1, Census Tract 202.03, Polk County, Oregon",511,266,245,41,053,020203,1
"Block Group 3, Census Tract 202.03, Polk County, Oregon",331,175,156,41,053,020203,3
"Block Group 2, Census Tract 202.03, Polk County, Oregon",234,98,136,41,053,020203,2
"Block Group 3, Census Tract 203.02, Polk County, Oregon",998,600,398,41,053,020302,3
"Block Group 4, Census Tract 203.02, Polk County, Oregon",401,178,223,41,053,020302,4
"Block Group 2, Census Tract 203.02, Polk County, Oregon",259,259,0,41,053,020302,2
"Block Group 2, Census Tract 304, Yamhill County, Oregon",782,716,66,41,071,030400,2
"Block Group 5, Census Tract 304, Yamhill County, Oregon",870,686,184,41,071,030400,5
"Block Group 1, Census Tract 304, Yamhill County, Oregon",315,262,53,41,071,030400,1
"Block Group 2, Census Tract 307.01, Yamhill County, Oregon",1752,1179,573,41,071,030701,2
"Block Group 1, Census Tract 308.01, Yamhill County, Oregon",748,161,587,41,071,030801,1
"Block Group 2, Census Tract 308.01, Yamhill County, Oregon",799,352,447,41,071,030801,2
"Block Group 3, Census Tract 305.02, Yamhill County, Oregon",405,215,190,41,071,030502,3
"Block Group 2, Census Tract 308.02, Yamhill County, Oregon",59,22,37,41,071,030802,2
"Block Group 1, Census Tract 308.02, Yamhill County, Oregon",831,331,500,41,071,030802,1
"Block Group 2, Census Tract 309, Yamhill County, Oregon",662,456,206,41,071,030900,2
"Block Group 3, Census Tract 302.02, Yamhill County, Oregon",999,625,374,41,071,030202,3
"Block Group 1, Census Tract 107.01, Marion County, Oregon",448,269,179,41,047,010701,1
"Block Group 1, Census Tract 15.03, Marion County, Oregon",587,280,307,41,047,001503,1
"Block Group 3, Census Tract 15.03, Marion County, Oregon",482,333,149,41,047,001503,3
"Block Group 1, Census Tract 16.01, Marion County, Oregon",562,391,171,41,047,001601,1
"Block Group 2, Census Tract 16.01, Marion County, Oregon",1015,878,137,41,047,001601,2
"Block Group 1, Census Tract 20, Marion County, Oregon",1203,712,491,41,047,002000,1
"Block Group 2, Census Tract 20, Marion County, Oregon",805,522,283,41,047,002000,2
"Block Group 1, Census Tract 16.03, Marion County, Oregon",631,597,34,41,047,001603,1
"Block Group 3, Census Tract 204, Polk County, Oregon",317,248,69,41,053,020400,3
"Block Group 1, Census Tract 9706, Union County, Oregon",453,363,90,41,061,970600,1
"Block Group 4, Census Tract 9706, Union County, Oregon",279,213,66,41,061,970600,4
"Block Group 3, Census Tract 306, Linn County, Oregon",474,392,82,41,043,030600,3
"Block Group 4, Census Tract 306, Linn County, Oregon",818,537,281,41,043,030600,4
"Block Group 2, Census Tract 306, Linn County, Oregon",509,373,136,41,043,030600,2
"Block Group 2, Census Tract 38.02, Multnomah County, Oregon",386,317,69,41,051,003802,2
"Block Group 1, Census Tract 38.02, Multnomah County, Oregon",582,232,350,41,051,003802,1
"Block Group 1, Census Tract 87, Multnomah County, Oregon",573,407,166,41,051,008700,1
"Block Group 3, Census Tract 87, Multnomah County, Oregon",542,394,148,41,051,008700,3
"Block Group 2, Census Tract 91.02, Multnomah County, Oregon",676,563,113,41,051,009102,2
"Block Group 1, Census Tract 91.02, Multnomah County, Oregon",394,145,249,41,051,009102,1
"Block Group 1, Census Tract 96.04, Multnomah County, Oregon",873,470,403,41,051,009604,1
"Block Group 2, Census Tract 96.04, Multnomah County, Oregon",976,402,574,41,051,009604,2
"Block Group 2, Census Tract 96.05, Multnomah County, Oregon",570,420,150,41,051,009605,2
"Block Group 1, Census Tract 96.05, Multnomah County, Oregon",914,306,608,41,051,009605,1
"Block Group 2, Census Tract 96.06, Multnomah County, Oregon",897,119,778,41,051,009606,2
"Block Group 1, Census Tract 96.06, Multnomah County, Oregon",1051,484,567,41,051,009606,1
"Block Group 3, Census Tract 6, Benton County, Oregon",809,359,450,41,003,000600,3
"Block Group 2, Census Tract 6, Benton County, Oregon",445,419,26,41,003,000600,2
"Block Group 2, Census Tract 103, Benton County, Oregon",364,326,38,41,003,010300,2
"Block Group 1, Census Tract 103, Benton County, Oregon",547,481,66,41,003,010300,1
"Block Group 3, Census Tract 103, Benton County, Oregon",429,337,92,41,003,010300,3
"Block Group 2, Census Tract 102, Benton County, Oregon",461,446,15,41,003,010200,2
"Block Group 3, Census Tract 102, Benton County, Oregon",380,304,76,41,003,010200,3
"Block Group 2, Census Tract 11.01, Benton County, Oregon",582,21,561,41,003,001101,2
"Block Group 2, Census Tract 317.04, Washington County, Oregon",439,439,0,41,067,031704,2
"Block Group 4, Census Tract 317.04, Washington County, Oregon",330,271,59,41,067,031704,4
"Block Group 1, Census Tract 11.01, Benton County, Oregon",374,99,275,41,003,001101,1
"Block Group 5, Census Tract 9702, Columbia County, Oregon",644,530,114,41,009,970200,5
"Block Group 1, Census Tract 9702, Columbia County, Oregon",421,269,152,41,009,970200,1
"Block Group 4, Census Tract 9702, Columbia County, Oregon",530,490,40,41,009,970200,4
"Block Group 3, Census Tract 9702, Columbia County, Oregon",519,406,113,41,009,970200,3
"Block Group 2, Census Tract 9708, Columbia County, Oregon",923,301,622,41,009,970800,2
"Block Group 3, Census Tract 9708, Columbia County, Oregon",1233,995,238,41,009,970800,3
"Block Group 3, Census Tract 9703, Columbia County, Oregon",292,250,42,41,009,970300,3
"Block Group 4, Census Tract 9703, Columbia County, Oregon",334,265,69,41,009,970300,4
"Block Group 2, Census Tract 21.02, Lane County, Oregon",965,165,800,41,039,002102,2
"Block Group 2, Census Tract 304.02, Washington County, Oregon",601,229,372,41,067,030402,2
"Block Group 3, Census Tract 306, Washington County, Oregon",441,369,72,41,067,030600,3
"Block Group 4, Census Tract 99.03, Multnomah County, Oregon",425,425,0,41,051,009903,4
"Block Group 3, Census Tract 102, Multnomah County, Oregon",1031,881,150,41,051,010200,3
"Block Group 5, Census Tract 94, Multnomah County, Oregon",495,374,121,41,051,009400,5
"Block Group 1, Census Tract 205.05, Clackamas County, Oregon",690,451,239,41,005,020505,1
"Block Group 1, Census Tract 204.03, Clackamas County, Oregon",915,874,41,41,005,020403,1
"Block Group 1, Census Tract 221.07, Clackamas County, Oregon",1154,214,940,41,005,022107,1
"Block Group 2, Census Tract 221.07, Clackamas County, Oregon",723,186,537,41,005,022107,2
"Block Group 2, Census Tract 221.05, Clackamas County, Oregon",952,755,197,41,005,022105,2
"Block Group 1, Census Tract 221.05, Clackamas County, Oregon",396,367,29,41,005,022105,1
"Block Group 1, Census Tract 221.08, Clackamas County, Oregon",461,446,15,41,005,022108,1
"Block Group 1, Census Tract 222.06, Clackamas County, Oregon",695,522,173,41,005,022206,1
"Block Group 1, Census Tract 222.05, Clackamas County, Oregon",762,483,279,41,005,022205,1
"Block Group 2, Census Tract 222.05, Clackamas County, Oregon",692,601,91,41,005,022205,2
"Block Group 1, Census Tract 222.08, Clackamas County, Oregon",1637,1243,394,41,005,022208,1
"Block Group 3, Census Tract 319.07, Washington County, Oregon",743,507,236,41,067,031907,3
"Block Group 1, Census Tract 319.08, Washington County, Oregon",1608,1391,217,41,067,031908,1
"Block Group 2, Census Tract 319.08, Washington County, Oregon",1352,1034,318,41,067,031908,2
"Block Group 2, Census Tract 318.13, Washington County, Oregon",983,503,480,41,067,031813,2
"Block Group 3, Census Tract 23.02, Lane County, Oregon",370,256,114,41,039,002302,3
"Block Group 1, Census Tract 23.02, Lane County, Oregon",746,632,114,41,039,002302,1
"Block Group 1, Census Tract 7.08, Lane County, Oregon",639,493,146,41,039,000708,1
"Block Group 3, Census Tract 7.07, Lane County, Oregon",688,369,319,41,039,000707,3
"Block Group 2, Census Tract 7.07, Lane County, Oregon",553,496,57,41,039,000707,2
"Block Group 0, Census Tract 9900, Lane County, Oregon",0,0,0,41,039,990000,0
"Block Group 1, Census Tract 25.04, Lane County, Oregon",250,209,41,41,039,002504,1
"Block Group 3, Census Tract 44.05, Lane County, Oregon",619,501,118,41,039,004405,3
"Block Group 2, Census Tract 33.02, Lane County, Oregon",561,224,337,41,039,003302,2
"Block Group 5, Census Tract 39.01, Multnomah County, Oregon",647,463,184,41,051,003901,5
"Block Group 4, Census Tract 39.01, Multnomah County, Oregon",547,321,226,41,051,003901,4
"Block Group 3, Census Tract 39.01, Multnomah County, Oregon",628,498,130,41,051,003901,3
"Block Group 1, Census Tract 39.01, Multnomah County, Oregon",517,382,135,41,051,003901,1
"Block Group 2, Census Tract 39.01, Multnomah County, Oregon",509,456,53,41,051,003901,2
"Block Group 1, Census Tract 55, Multnomah County, Oregon",874,197,677,41,051,005500,1
"Block Group 5, Census Tract 58, Multnomah County, Oregon",401,401,0,41,051,005800,5
"Block Group 3, Census Tract 58, Multnomah County, Oregon",367,0,367,41,051,005800,3
"Block Group 4, Census Tract 58, Multnomah County, Oregon",480,415,65,41,051,005800,4
"Block Group 1, Census Tract 58, Multnomah County, Oregon",505,224,281,41,051,005800,1
"Block Group 2, Census Tract 58, Multnomah County, Oregon",620,269,351,41,051,005800,2
"Block Group 1, Census Tract 59, Multnomah County, Oregon",3202,1137,2065,41,051,005900,1
"Block Group 3, Census Tract 24.01, Multnomah County, Oregon",336,249,87,41,051,002401,3
"Block Group 2, Census Tract 34.02, Multnomah County, Oregon",535,128,407,41,051,003402,2
"Block Group 3, Census Tract 34.02, Multnomah County, Oregon",708,195,513,41,051,003402,3
"Block Group 4, Census Tract 35.01, Multnomah County, Oregon",339,115,224,41,051,003501,4
"Block Group 2, Census Tract 35.01, Multnomah County, Oregon",479,297,182,41,051,003501,2
"Block Group 1, Census Tract 35.01, Multnomah County, Oregon",368,71,297,41,051,003501,1
"Block Group 4, Census Tract 1, Lane County, Oregon",404,278,126,41,039,000100,4
"Block Group 1, Census Tract 1, Lane County, Oregon",498,434,64,41,039,000100,1
"Block Group 3, Census Tract 1, Lane County, Oregon",538,486,52,41,039,000100,3
"Block Group 3, Census Tract 5, Lane County, Oregon",380,302,78,41,039,000500,3
"Block Group 2, Census Tract 5, Lane County, Oregon",177,127,50,41,039,000500,2
"Block Group 2, Census Tract 8, Lane County, Oregon",379,331,48,41,039,000800,2
"Block Group 1, Census Tract 31.01, Lane County, Oregon",670,636,34,41,039,003101,1
"Block Group 2, Census Tract 31.01, Lane County, Oregon",588,324,264,41,039,003101,2
"Block Group 3, Census Tract 40, Lane County, Oregon",320,89,231,41,039,004000,3
"Block Group 2, Census Tract 40, Lane County, Oregon",344,112,232,41,039,004000,2
"Block Group 4, Census Tract 44.01, Lane County, Oregon",582,193,389,41,039,004401,4
"Block Group 1, Census Tract 7, Coos County, Oregon",551,133,418,41,011,000700,1
"Block Group 7, Census Tract 7, Coos County, Oregon",423,383,40,41,011,000700,7
"Block Group 3, Census Tract 7, Coos County, Oregon",108,80,28,41,011,000700,3
"Block Group 8, Census Tract 7, Coos County, Oregon",650,428,222,41,011,000700,8
"Block Group 4, Census Tract 7, Coos County, Oregon",368,7,361,41,011,000700,4
"Block Group 6, Census Tract 7, Coos County, Oregon",536,313,223,41,011,000700,6
"Block Group 6, Census Tract 10, Coos County, Oregon",389,307,82,41,011,001000,6
"Block Group 7, Census Tract 10, Coos County, Oregon",495,237,258,41,011,001000,7
"Block Group 1, Census Tract 10, Coos County, Oregon",272,214,58,41,011,001000,1
"Block Group 1, Census Tract 11, Coos County, Oregon",292,238,54,41,011,001100,1
"Block Group 3, Census Tract 21.02, Lane County, Oregon",1008,377,631,41,039,002102,3
"Block Group 3, Census Tract 301, Linn County, Oregon",328,262,66,41,043,030100,3
"Block Group 1, Census Tract 9602, Tillamook County, Oregon",315,238,77,41,057,960200,1
"Block Group 1, Census Tract 68.01, Multnomah County, Oregon",1085,675,410,41,051,006801,1
"Block Group 2, Census Tract 95.01, Multnomah County, Oregon",756,459,297,41,051,009501,2
"Block Group 2, Census Tract 94, Multnomah County, Oregon",434,353,81,41,051,009400,2
"Block Group 3, Census Tract 94, Multnomah County, Oregon",538,439,99,41,051,009400,3
"Block Group 4, Census Tract 94, Multnomah County, Oregon",435,392,43,41,051,009400,4
"Block Group 2, Census Tract 9703, Union County, Oregon",659,488,171,41,061,970300,2
"Block Group 1, Census Tract 9707, Union County, Oregon",421,70,351,41,061,970700,1
"Block Group 3, Census Tract 9707, Union County, Oregon",660,197,463,41,061,970700,3
"Block Group 2, Census Tract 324.06, Washington County, Oregon",434,374,60,41,067,032406,2
"Block Group 1, Census Tract 34, Lane County, Oregon",530,192,338,41,039,003400,1
"Block Group 2, Census Tract 34, Lane County, Oregon",399,242,157,41,039,003400,2
"Block Group 3, Census Tract 34, Lane County, Oregon",655,217,438,41,039,003400,3
"Block Group 4, Census Tract 34, Lane County, Oregon",428,184,244,41,039,003400,4
"Block Group 2, Census Tract 41, Lane County, Oregon",535,326,209,41,039,004100,2
"Block Group 1, Census Tract 41, Lane County, Oregon",419,237,182,41,039,004100,1
"Block Group 3, Census Tract 41, Lane County, Oregon",482,331,151,41,039,004100,3
"Block Group 4, Census Tract 41, Lane County, Oregon",318,267,51,41,039,004100,4
"Block Group 1, Census Tract 49, Lane County, Oregon",569,468,101,41,039,004900,1
"Block Group 3, Census Tract 49, Lane County, Oregon",450,347,103,41,039,004900,3
"Block Group 1, Census Tract 17.02, Multnomah County, Oregon",712,257,455,41,051,001702,1
"Block Group 2, Census Tract 17.02, Multnomah County, Oregon",446,332,114,41,051,001702,2
"Block Group 3, Census Tract 17.02, Multnomah County, Oregon",433,283,150,41,051,001702,3
"Block Group 4, Census Tract 19, Multnomah County, Oregon",480,440,40,41,051,001900,4
"Block Group 1, Census Tract 19, Multnomah County, Oregon",586,270,316,41,051,001900,1
"Block Group 1, Census Tract 25.01, Multnomah County, Oregon",262,235,27,41,051,002501,1
"Block Group 5, Census Tract 25.01, Multnomah County, Oregon",290,277,13,41,051,002501,5
"Block Group 4, Census Tract 25.01, Multnomah County, Oregon",227,227,0,41,051,002501,4
"Block Group 6, Census Tract 25.01, Multnomah County, Oregon",244,226,18,41,051,002501,6
"Block Group 2, Census Tract 26, Multnomah County, Oregon",351,328,23,41,051,002600,2
"Block Group 3, Census Tract 26, Multnomah County, Oregon",329,282,47,41,051,002600,3
"Block Group 2, Census Tract 27.02, Multnomah County, Oregon",1092,261,831,41,051,002702,2
"Block Group 1, Census Tract 29.02, Multnomah County, Oregon",478,343,135,41,051,002902,1
"Block Group 2, Census Tract 29.02, Multnomah County, Oregon",361,361,0,41,051,002902,2
"Block Group 4, Census Tract 29.02, Multnomah County, Oregon",643,211,432,41,051,002902,4
"Block Group 1, Census Tract 20, Deschutes County, Oregon",619,605,14,41,017,002000,1
"Block Group 3, Census Tract 218.01, Clackamas County, Oregon",736,717,19,41,005,021801,3
"Block Group 3, Census Tract 17.01, Multnomah County, Oregon",245,169,76,41,051,001701,3
"Block Group 2, Census Tract 17.01, Multnomah County, Oregon",719,485,234,41,051,001701,2
"Block Group 7, Census Tract 17.01, Multnomah County, Oregon",611,288,323,41,051,001701,7
"Block Group 4, Census Tract 17.01, Multnomah County, Oregon",309,172,137,41,051,001701,4
"Block Group 5, Census Tract 17.01, Multnomah County, Oregon",442,363,79,41,051,001701,5
"Block Group 1, Census Tract 66.02, Multnomah County, Oregon",445,168,277,41,051,006602,1
"Block Group 2, Census Tract 66.02, Multnomah County, Oregon",1293,528,765,41,051,006602,2
"Block Group 3, Census Tract 66.02, Multnomah County, Oregon",777,573,204,41,051,006602,3
"Block Group 1, Census Tract 7.02, Multnomah County, Oregon",520,244,276,41,051,000702,1
"Block Group 3, Census Tract 7.02, Multnomah County, Oregon",563,353,210,41,051,000702,3
"Block Group 2, Census Tract 7.02, Multnomah County, Oregon",494,358,136,41,051,000702,2
"Block Group 4, Census Tract 7.02, Multnomah County, Oregon",507,375,132,41,051,000702,4
"Block Group 1, Census Tract 18.01, Multnomah County, Oregon",659,200,459,41,051,001801,1
"Block Group 2, Census Tract 18.01, Multnomah County, Oregon",582,243,339,41,051,001801,2
"Block Group 1, Census Tract 18.02, Multnomah County, Oregon",1052,513,539,41,051,001802,1
"Block Group 2, Census Tract 21, Multnomah County, Oregon",987,172,815,41,051,002100,2
"Block Group 2, Census Tract 104, Marion County, Oregon",445,241,204,41,047,010400,2
"Block Group 3, Census Tract 104, Marion County, Oregon",292,226,66,41,047,010400,3
"Block Group 4, Census Tract 104, Marion County, Oregon",570,299,271,41,047,010400,4
"Block Group 3, Census Tract 103.05, Marion County, Oregon",461,403,58,41,047,010305,3
"Block Group 1, Census Tract 103.05, Marion County, Oregon",486,101,385,41,047,010305,1
"Block Group 2, Census Tract 103.05, Marion County, Oregon",297,116,181,41,047,010305,2
"Block Group 1, Census Tract 315.09, Washington County, Oregon",2134,1328,806,41,067,031509,1
"Block Group 2, Census Tract 100.02, Multnomah County, Oregon",989,584,405,41,051,010002,2
"Block Group 1, Census Tract 6, Deschutes County, Oregon",1802,1502,300,41,017,000600,1
"Block Group 2, Census Tract 6, Deschutes County, Oregon",410,363,47,41,017,000600,2
"Block Group 4, Census Tract 6, Deschutes County, Oregon",784,661,123,41,017,000600,4
"Block Group 1, Census Tract 4.02, Deschutes County, Oregon",634,491,143,41,017,000402,1
"Block Group 2, Census Tract 4.02, Deschutes County, Oregon",347,273,74,41,017,000402,2
"Block Group 3, Census Tract 4.02, Deschutes County, Oregon",125,125,0,41,017,000402,3
"Block Group 3, Census Tract 19.02, Deschutes County, Oregon",350,333,17,41,017,001902,3
"Block Group 4, Census Tract 19.02, Deschutes County, Oregon",563,448,115,41,017,001902,4
"Block Group 1, Census Tract 19.02, Deschutes County, Oregon",2448,1060,1388,41,017,001902,1
"Block Group 2, Census Tract 19.02, Deschutes County, Oregon",706,670,36,41,017,001902,2
"Block Group 1, Census Tract 19.01, Deschutes County, Oregon",697,674,23,41,017,001901,1
"Block Group 1, Census Tract 10.02, Deschutes County, Oregon",959,861,98,41,017,001002,1
"Block Group 1, Census Tract 10.01, Deschutes County, Oregon",985,902,83,41,017,001001,1
"Block Group 5, Census Tract 10.01, Deschutes County, Oregon",1101,669,432,41,017,001001,5
"Block Group 2, Census Tract 10.01, Jackson County, Oregon",206,101,105,41,029,001001,2
"Block Group 1, Census Tract 10.01, Jackson County, Oregon",688,358,330,41,029,001001,1
"Block Group 5, Census Tract 7, Jackson County, Oregon",1092,647,445,41,029,000700,5
"Block Group 4, Census Tract 15, Jackson County, Oregon",826,359,467,41,029,001500,4
"Block Group 4, Census Tract 6.01, Jackson County, Oregon",653,380,273,41,029,000601,4
"Block Group 1, Census Tract 243.03, Clackamas County, Oregon",687,588,99,41,005,024303,1
"Block Group 2, Census Tract 243.03, Clackamas County, Oregon",551,440,111,41,005,024303,2
"Block Group 2, Census Tract 243.04, Clackamas County, Oregon",193,150,43,41,005,024304,2
"Block Group 3, Census Tract 20, Marion County, Oregon",952,719,233,41,047,002000,3
"Block Group 1, Census Tract 243.04, Clackamas County, Oregon",841,732,109,41,005,024304,1
"Block Group 2, Census Tract 221.03, Clackamas County, Oregon",1587,1239,348,41,005,022103,2
"Block Group 3, Census Tract 23.03, Marion County, Oregon",846,426,420,41,047,002303,3
"Block Group 1, Census Tract 23.03, Marion County, Oregon",1200,896,304,41,047,002303,1
"Block Group 1, Census Tract 22.02, Marion County, Oregon",1031,849,182,41,047,002202,1
"Block Group 2, Census Tract 22.02, Marion County, Oregon",423,146,277,41,047,002202,2
"Block Group 2, Census Tract 21.01, Marion County, Oregon",353,157,196,41,047,002101,2
"Block Group 2, Census Tract 25.01, Marion County, Oregon",790,509,281,41,047,002501,2
"Block Group 1, Census Tract 23.04, Marion County, Oregon",1109,973,136,41,047,002304,1
"Block Group 2, Census Tract 23.04, Marion County, Oregon",156,69,87,41,047,002304,2
"Block Group 4, Census Tract 23.04, Marion County, Oregon",322,289,33,41,047,002304,4
"Block Group 1, Census Tract 102.02, Marion County, Oregon",586,537,49,41,047,010202,1
"Block Group 3, Census Tract 102.02, Marion County, Oregon",289,230,59,41,047,010202,3
"Block Group 1, Census Tract 229.04, Clackamas County, Oregon",700,331,369,41,005,022904,1
"Block Group 2, Census Tract 229.04, Clackamas County, Oregon",673,267,406,41,005,022904,2
"Block Group 2, Census Tract 229.05, Clackamas County, Oregon",610,596,14,41,005,022905,2
"Block Group 1, Census Tract 229.05, Clackamas County, Oregon",483,483,0,41,005,022905,1
"Block Group 1, Census Tract 230.02, Clackamas County, Oregon",609,587,22,41,005,023002,1
"Block Group 1, Census Tract 9601, Wheeler County, Oregon",260,202,58,41,069,960100,1
"Block Group 2, Census Tract 12, Deschutes County, Oregon",196,182,14,41,017,001200,2
"Block Group 4, Census Tract 312, Washington County, Oregon",824,178,646,41,067,031200,4
"Block Group 2, Census Tract 11.01, Multnomah County, Oregon",953,162,791,41,051,001101,2
"Block Group 4, Census Tract 9709, Malheur County, Oregon",184,155,29,41,045,970900,4
"Block Group 1, Census Tract 9709, Malheur County, Oregon",257,193,64,41,045,970900,1
"Block Group 3, Census Tract 24.01, Lane County, Oregon",631,553,78,41,039,002401,3
"Block Group 3, Census Tract 208.02, Linn County, Oregon",617,43,574,41,043,020802,3
"Block Group 1, Census Tract 208.02, Linn County, Oregon",441,245,196,41,043,020802,1
"Block Group 4, Census Tract 208.02, Linn County, Oregon",718,210,508,41,043,020802,4
"Block Group 1, Census Tract 24.02, Multnomah County, Oregon",671,164,507,41,051,002402,1
"Block Group 3, Census Tract 24.02, Multnomah County, Oregon",566,187,379,41,051,002402,3
"Block Group 1, Census Tract 29.03, Multnomah County, Oregon",713,295,418,41,051,002903,1
"Block Group 2, Census Tract 29.03, Multnomah County, Oregon",455,418,37,41,051,002903,2
"Block Group 4, Census Tract 29.03, Multnomah County, Oregon",572,354,218,41,051,002903,4
"Block Group 1, Census Tract 33.01, Multnomah County, Oregon",450,218,232,41,051,003301,1
"Block Group 2, Census Tract 33.01, Multnomah County, Oregon",454,161,293,41,051,003301,2
"Block Group 2, Census Tract 37.02, Multnomah County, Oregon",256,151,105,41,051,003702,2
"Block Group 3, Census Tract 37.02, Multnomah County, Oregon",485,244,241,41,051,003702,3
"Block Group 1, Census Tract 329.02, Washington County, Oregon",430,307,123,41,067,032902,1
"Block Group 2, Census Tract 99.03, Multnomah County, Oregon",630,565,65,41,051,009903,2
"Block Group 2, Census Tract 101, Multnomah County, Oregon",1871,696,1175,41,051,010100,2
"Block Group 1, Census Tract 101, Multnomah County, Oregon",303,264,39,41,051,010100,1
"Block Group 3, Census Tract 101, Multnomah County, Oregon",848,326,522,41,051,010100,3
"Block Group 1, Census Tract 103.06, Multnomah County, Oregon",515,439,76,41,051,010306,1
"Block Group 1, Census Tract 104.09, Multnomah County, Oregon",1752,919,833,41,051,010409,1
"Block Group 3, Census Tract 104.09, Multnomah County, Oregon",394,337,57,41,051,010409,3
"Block Group 6, Census Tract 16.01, Multnomah County, Oregon",289,275,14,41,051,001601,6
"Block Group 4, Census Tract 16.01, Multnomah County, Oregon",679,275,404,41,051,001601,4
"Block Group 2, Census Tract 16.01, Multnomah County, Oregon",256,203,53,41,051,001601,2
"Block Group 3, Census Tract 16.01, Multnomah County, Oregon",513,250,263,41,051,001601,3
"Block Group 1, Census Tract 6.01, Multnomah County, Oregon",691,373,318,41,051,000601,1
"Block Group 4, Census Tract 9.01, Multnomah County, Oregon",470,202,268,41,051,000901,4
"Block Group 2, Census Tract 9.01, Multnomah County, Oregon",465,254,211,41,051,000901,2
"Block Group 1, Census Tract 9.01, Multnomah County, Oregon",625,431,194,41,051,000901,1
"Block Group 2, Census Tract 324.10, Washington County, Oregon",376,241,135,41,067,032410,2
"Block Group 3, Census Tract 324.10, Washington County, Oregon",276,38,238,41,067,032410,3
"Block Group 1, Census Tract 325.02, Washington County, Oregon",1032,676,356,41,067,032502,1
"Block Group 1, Census Tract 325.01, Washington County, Oregon",631,264,367,41,067,032501,1
"Block Group 2, Census Tract 325.01, Washington County, Oregon",293,95,198,41,067,032501,2
"Block Group 5, Census Tract 315.08, Washington County, Oregon",494,451,43,41,067,031508,5
"Block Group 4, Census Tract 315.08, Washington County, Oregon",482,482,0,41,067,031508,4
"Block Group 3, Census Tract 329.02, Washington County, Oregon",383,299,84,41,067,032902,3
"Block Group 4, Census Tract 329.02, Washington County, Oregon",688,604,84,41,067,032902,4
"Block Group 4, Census Tract 308.03, Washington County, Oregon",604,245,359,41,067,030803,4
"Block Group 2, Census Tract 5.01, Marion County, Oregon",661,444,217,41,047,000501,2
"Block Group 1, Census Tract 5.01, Marion County, Oregon",428,294,134,41,047,000501,1
"Block Group 2, Census Tract 7.06, Lane County, Oregon",683,546,137,41,039,000706,2
"Block Group 1, Census Tract 18.03, Marion County, Oregon",1000,699,301,41,047,001803,1
"Block Group 2, Census Tract 18.03, Marion County, Oregon",107,107,0,41,047,001803,2
"Block Group 2, Census Tract 26, Marion County, Oregon",342,242,100,41,047,002600,2
"Block Group 1, Census Tract 26, Marion County, Oregon",340,290,50,41,047,002600,1
"Block Group 1, Census Tract 242, Clackamas County, Oregon",575,264,311,41,005,024200,1
"Block Group 2, Census Tract 242, Clackamas County, Oregon",1094,1020,74,41,005,024200,2
"Block Group 4, Census Tract 242, Clackamas County, Oregon",420,362,58,41,005,024200,4
"Block Group 3, Census Tract 242, Clackamas County, Oregon",407,368,39,41,005,024200,3
"Block Group 1, Census Tract 210, Clackamas County, Oregon",469,347,122,41,005,021000,1
"Block Group 3, Census Tract 210, Clackamas County, Oregon",531,352,179,41,005,021000,3
"Block Group 1, Census Tract 218.01, Clackamas County, Oregon",901,864,37,41,005,021801,1
"Block Group 2, Census Tract 218.01, Clackamas County, Oregon",600,568,32,41,005,021801,2
"Block Group 2, Census Tract 227.02, Clackamas County, Oregon",682,604,78,41,005,022702,2
"Block Group 1, Census Tract 227.02, Clackamas County, Oregon",1131,790,341,41,005,022702,1
"Block Group 2, Census Tract 213, Clackamas County, Oregon",756,678,78,41,005,021300,2
"Block Group 1, Census Tract 213, Clackamas County, Oregon",1290,739,551,41,005,021300,1
"Block Group 2, Census Tract 204.01, Clackamas County, Oregon",364,248,116,41,005,020401,2
"Block Group 3, Census Tract 204.01, Clackamas County, Oregon",613,499,114,41,005,020401,3
"Block Group 1, Census Tract 3613, Josephine County, Oregon",916,858,58,41,033,361300,1
"Block Group 3, Census Tract 3613, Josephine County, Oregon",540,462,78,41,033,361300,3
"Block Group 2, Census Tract 3614, Josephine County, Oregon",733,515,218,41,033,361400,2
"Block Group 2, Census Tract 3607.01, Josephine County, Oregon",374,77,297,41,033,360701,2
"Block Group 1, Census Tract 3607.01, Josephine County, Oregon",1107,676,431,41,033,360701,1
"Block Group 4, Census Tract 3603, Josephine County, Oregon",604,398,206,41,033,360300,4
"Block Group 3, Census Tract 3603, Josephine County, Oregon",742,609,133,41,033,360300,3
"Block Group 2, Census Tract 3604, Josephine County, Oregon",1072,894,178,41,033,360400,2
"Block Group 1, Census Tract 3612, Josephine County, Oregon",1123,269,854,41,033,361200,1
"Block Group 3, Census Tract 3612, Josephine County, Oregon",803,492,311,41,033,361200,3
"Block Group 1, Census Tract 3601, Josephine County, Oregon",523,432,91,41,033,360100,1
"Block Group 2, Census Tract 3601, Josephine County, Oregon",321,254,67,41,033,360100,2
"Block Group 1, Census Tract 3609, Josephine County, Oregon",810,610,200,41,033,360900,1
"Block Group 2, Census Tract 3606, Josephine County, Oregon",815,683,132,41,033,360600,2
"Block Group 3, Census Tract 3606, Josephine County, Oregon",307,226,81,41,033,360600,3
"Block Group 1, Census Tract 3606, Josephine County, Oregon",659,470,189,41,033,360600,1
"Block Group 5, Census Tract 27, Marion County, Oregon",750,690,60,41,047,002700,5
"Block Group 2, Census Tract 12.02, Multnomah County, Oregon",569,417,152,41,051,001202,2
"Block Group 1, Census Tract 12.02, Multnomah County, Oregon",565,363,202,41,051,001202,1
"Block Group 3, Census Tract 6.02, Jackson County, Oregon",787,333,454,41,029,000602,3
"Block Group 1, Census Tract 103.07, Marion County, Oregon",1430,1389,41,41,047,010307,1
"Block Group 2, Census Tract 103.07, Marion County, Oregon",399,341,58,41,047,010307,2
"Block Group 1, Census Tract 102.01, Marion County, Oregon",567,456,111,41,047,010201,1
"Block Group 2, Census Tract 102.01, Marion County, Oregon",519,428,91,41,047,010201,2
"Block Group 2, Census Tract 22.01, Marion County, Oregon",257,186,71,41,047,002201,2
"Block Group 3, Census Tract 1300, Douglas County, Oregon",462,244,218,41,019,130000,3
"Block Group 2, Census Tract 1700, Douglas County, Oregon",940,738,202,41,019,170000,2
"Block Group 1, Census Tract 1700, Douglas County, Oregon",402,356,46,41,019,170000,1
"Block Group 1, Census Tract 300, Douglas County, Oregon",355,326,29,41,019,030000,1
"Block Group 2, Census Tract 300, Douglas County, Oregon",547,424,123,41,019,030000,2
"Block Group 3, Census Tract 300, Douglas County, Oregon",638,499,139,41,019,030000,3
"Block Group 1, Census Tract 600, Douglas County, Oregon",364,327,37,41,019,060000,1
"Block Group 3, Census Tract 330, Washington County, Oregon",551,438,113,41,067,033000,3
"Block Group 4, Census Tract 330, Washington County, Oregon",612,488,124,41,067,033000,4
"Block Group 2, Census Tract 330, Washington County, Oregon",508,306,202,41,067,033000,2
"Block Group 1, Census Tract 330, Washington County, Oregon",371,361,10,41,067,033000,1
"Block Group 2, Census Tract 336, Washington County, Oregon",240,234,6,41,067,033600,2
"Block Group 3, Census Tract 336, Washington County, Oregon",313,262,51,41,067,033600,3
"Block Group 1, Census Tract 336, Washington County, Oregon",288,249,39,41,067,033600,1
"Block Group 4, Census Tract 310.05, Washington County, Oregon",427,181,246,41,067,031005,4
"Block Group 1, Census Tract 310.05, Washington County, Oregon",443,190,253,41,067,031005,1
"Block Group 2, Census Tract 9515, Lincoln County, Oregon",926,768,158,41,041,951500,2
"Block Group 2, Census Tract 9513, Lincoln County, Oregon",556,378,178,41,041,951300,2
"Block Group 2, Census Tract 5, Benton County, Oregon",537,497,40,41,003,000500,2
"Block Group 1, Census Tract 5, Benton County, Oregon",439,340,99,41,003,000500,1
"Block Group 3, Census Tract 9, Benton County, Oregon",1115,375,740,41,003,000900,3
"Block Group 4, Census Tract 9, Benton County, Oregon",451,424,27,41,003,000900,4
"Block Group 5, Census Tract 9, Benton County, Oregon",317,317,0,41,003,000900,5
"Block Group 3, Census Tract 10.02, Benton County, Oregon",414,270,144,41,003,001002,3
"Block Group 1, Census Tract 10.02, Benton County, Oregon",300,160,140,41,003,001002,1
"Block Group 2, Census Tract 32.02, Lane County, Oregon",493,344,149,41,039,003202,2
"Block Group 1, Census Tract 25.01, Lane County, Oregon",458,356,102,41,039,002501,1
"Block Group 3, Census Tract 25.01, Lane County, Oregon",599,329,270,41,039,002501,3
"Block Group 2, Census Tract 27, Lane County, Oregon",705,358,347,41,039,002700,2
"Block Group 2, Census Tract 32.01, Lane County, Oregon",1001,459,542,41,039,003201,2
"Block Group 2, Census Tract 12.02, Lane County, Oregon",497,292,205,41,039,001202,2
"Block Group 1, Census Tract 7.06, Lane County, Oregon",529,418,111,41,039,000706,1
"Block Group 3, Census Tract 9506.01, Lincoln County, Oregon",498,416,82,41,041,950601,3
"Block Group 2, Census Tract 9506.01, Lincoln County, Oregon",542,455,87,41,041,950601,2
"Block Group 3, Census Tract 5.04, Coos County, Oregon",342,169,173,41,011,000504,3
"Block Group 2, Census Tract 5.04, Coos County, Oregon",607,573,34,41,011,000504,2
"Block Group 5, Census Tract 5.04, Coos County, Oregon",986,573,413,41,011,000504,5
"Block Group 1, Census Tract 5.03, Coos County, Oregon",551,373,178,41,011,000503,1
"Block Group 3, Census Tract 33.01, Lane County, Oregon",364,180,184,41,039,003301,3
"Block Group 2, Census Tract 33.01, Lane County, Oregon",408,188,220,41,039,003301,2
"Block Group 2, Census Tract 5.03, Coos County, Oregon",511,244,267,41,011,000503,2
"Block Group 1, Census Tract 229.07, Clackamas County, Oregon",798,606,192,41,005,022907,1
"Block Group 2, Census Tract 9506.02, Lincoln County, Oregon",810,535,275,41,041,950602,2
"Block Group 0, Census Tract 9901, Lincoln County, Oregon",0,0,0,41,041,990100,0
"Block Group 1, Census Tract 9503.04, Lincoln County, Oregon",486,258,228,41,041,950304,1
"Block Group 1, Census Tract 227.07, Clackamas County, Oregon",452,441,11,41,005,022707,1
"Block Group 2, Census Tract 229.06, Clackamas County, Oregon",514,369,145,41,005,022906,2
"Block Group 2, Census Tract 319.09, Washington County, Oregon",706,659,47,41,067,031909,2
"Block Group 1, Census Tract 318.12, Washington County, Oregon",1020,766,254,41,067,031812,1
"Block Group 2, Census Tract 318.12, Washington County, Oregon",1643,465,1178,41,067,031812,2
"Block Group 4, Census Tract 70, Multnomah County, Oregon",1739,1307,432,41,051,007000,4
"Block Group 4, Census Tract 305.01, Yamhill County, Oregon",43,22,21,41,071,030501,4
"Block Group 2, Census Tract 324.09, Washington County, Oregon",859,214,645,41,067,032409,2
"Block Group 1, Census Tract 333.02, Washington County, Oregon",715,673,42,41,067,033302,1
"Block Group 0, Census Tract 9901.01, Curry County, Oregon",0,0,0,41,015,990101,0
"Block Group 0, Census Tract 9901, Tillamook County, Oregon",0,0,0,41,057,990100,0
"Block Group 3, Census Tract 333.01, Washington County, Oregon",339,78,261,41,067,033301,3
"Block Group 2, Census Tract 333.01, Washington County, Oregon",245,67,178,41,067,033301,2
"Block Group 3, Census Tract 318.15, Washington County, Oregon",417,351,66,41,067,031815,3
"Block Group 2, Census Tract 6.02, Jackson County, Oregon",1122,471,651,41,029,000602,2
"Block Group 1, Census Tract 325.03, Washington County, Oregon",843,725,118,41,067,032503,1
"Block Group 4, Census Tract 302, Washington County, Oregon",580,478,102,41,067,030200,4
"Block Group 4, Census Tract 104.05, Multnomah County, Oregon",669,185,484,41,051,010405,4
"Block Group 2, Census Tract 64.04, Multnomah County, Oregon",938,542,396,41,051,006404,2
"Block Group 1, Census Tract 64.04, Multnomah County, Oregon",858,728,130,41,051,006404,1
"Block Group 1, Census Tract 99.05, Multnomah County, Oregon",479,443,36,41,051,009905,1
"Block Group 2, Census Tract 99.05, Multnomah County, Oregon",716,487,229,41,051,009905,2
"Block Group 2, Census Tract 99.07, Multnomah County, Oregon",471,280,191,41,051,009907,2
"Block Group 1, Census Tract 99.07, Multnomah County, Oregon",317,175,142,41,051,009907,1
"Block Group 3, Census Tract 99.07, Multnomah County, Oregon",1207,1056,151,41,051,009907,3
"Block Group 2, Census Tract 104.11, Multnomah County, Oregon",723,441,282,41,051,010411,2
"Block Group 2, Census Tract 315.13, Washington County, Oregon",1275,933,342,41,067,031513,2
"Block Group 3, Census Tract 315.13, Washington County, Oregon",1723,1505,218,41,067,031513,3
"Block Group 4, Census Tract 301.01, Washington County, Oregon",961,218,743,41,067,030101,4
"Block Group 1, Census Tract 301.01, Washington County, Oregon",488,475,13,41,067,030101,1
"Block Group 3, Census Tract 301.01, Washington County, Oregon",2101,799,1302,41,067,030101,3
"Block Group 1, Census Tract 301.02, Washington County, Oregon",1556,642,914,41,067,030102,1
"Block Group 2, Census Tract 316.15, Washington County, Oregon",446,327,119,41,067,031615,2
"Block Group 4, Census Tract 316.15, Washington County, Oregon",248,220,28,41,067,031615,4
"Block Group 1, Census Tract 316.15, Washington County, Oregon",521,228,293,41,067,031615,1
"Block Group 1, Census Tract 324.08, Washington County, Oregon",932,640,292,41,067,032408,1
"Block Group 1, Census Tract 326.08, Washington County, Oregon",990,549,441,41,067,032608,1
"Block Group 2, Census Tract 326.10, Washington County, Oregon",305,223,82,41,067,032610,2
"Block Group 1, Census Tract 321.07, Washington County, Oregon",769,711,58,41,067,032107,1
"Block Group 2, Census Tract 321.04, Washington County, Oregon",818,511,307,41,067,032104,2
"Block Group 3, Census Tract 326.06, Washington County, Oregon",315,260,55,41,067,032606,3
"Block Group 5, Census Tract 326.06, Washington County, Oregon",312,312,0,41,067,032606,5
"Block Group 4, Census Tract 326.06, Washington County, Oregon",427,281,146,41,067,032606,4
"Block Group 3, Census Tract 9501, Clatsop County, Oregon",660,251,409,41,007,950100,3
"Block Group 1, Census Tract 9501, Clatsop County, Oregon",322,170,152,41,007,950100,1
"Block Group 1, Census Tract 9507, Clatsop County, Oregon",497,353,144,41,007,950700,1
"Block Group 3, Census Tract 9504, Clatsop County, Oregon",307,307,0,41,007,950400,3
"Block Group 1, Census Tract 9504, Clatsop County, Oregon",441,346,95,41,007,950400,1
"Block Group 1, Census Tract 9511, Clatsop County, Oregon",773,406,367,41,007,951100,1
"Block Group 3, Census Tract 9511, Clatsop County, Oregon",378,129,249,41,007,951100,3
"Block Group 2, Census Tract 2, Coos County, Oregon",550,421,129,41,011,000200,2
"Block Group 1, Census Tract 2, Coos County, Oregon",304,258,46,41,011,000200,1
"Block Group 5, Census Tract 306, Linn County, Oregon",518,453,65,41,043,030600,5
"Block Group 1, Census Tract 202, Linn County, Oregon",864,471,393,41,043,020200,1
"Block Group 1, Census Tract 205, Linn County, Oregon",619,396,223,41,043,020500,1
"Block Group 2, Census Tract 205, Linn County, Oregon",1094,476,618,41,043,020500,2
"Block Group 4, Census Tract 2100, Douglas County, Oregon",633,381,252,41,019,210000,4
"Block Group 2, Census Tract 2100, Douglas County, Oregon",383,298,85,41,019,210000,2
"Block Group 5, Census Tract 2100, Douglas County, Oregon",320,194,126,41,019,210000,5
"Block Group 3, Census Tract 2100, Douglas County, Oregon",302,119,183,41,019,210000,3
"Block Group 2, Census Tract 100, Douglas County, Oregon",647,361,286,41,019,010000,2
"Block Group 1, Census Tract 100, Douglas County, Oregon",473,300,173,41,019,010000,1
"Block Group 2, Census Tract 400, Douglas County, Oregon",572,430,142,41,019,040000,2
"Block Group 3, Census Tract 400, Douglas County, Oregon",304,259,45,41,019,040000,3
"Block Group 1, Census Tract 400, Douglas County, Oregon",300,273,27,41,019,040000,1
"Block Group 1, Census Tract 500.02, Douglas County, Oregon",1248,784,464,41,019,050002,1
"Block Group 4, Census Tract 500.02, Douglas County, Oregon",574,457,117,41,019,050002,4
"Block Group 2, Census Tract 1000, Douglas County, Oregon",457,291,166,41,019,100000,2
"Block Group 3, Census Tract 1000, Douglas County, Oregon",431,207,224,41,019,100000,3
"Block Group 4, Census Tract 1200, Douglas County, Oregon",446,252,194,41,019,120000,4
"Block Group 5, Census Tract 1200, Douglas County, Oregon",262,154,108,41,019,120000,5
"Block Group 1, Census Tract 1200, Douglas County, Oregon",1032,735,297,41,019,120000,1
"Block Group 2, Census Tract 1200, Douglas County, Oregon",909,382,527,41,019,120000,2
"Block Group 1, Census Tract 900, Douglas County, Oregon",413,339,74,41,019,090000,1
"Block Group 2, Census Tract 900, Douglas County, Oregon",367,306,61,41,019,090000,2
"Block Group 2, Census Tract 309.02, Linn County, Oregon",636,521,115,41,043,030902,2
"Block Group 3, Census Tract 309.02, Linn County, Oregon",569,512,57,41,043,030902,3
"Block Group 5, Census Tract 309.02, Linn County, Oregon",881,565,316,41,043,030902,5
"Block Group 3, Census Tract 309.03, Linn County, Oregon",913,646,267,41,043,030903,3
"Block Group 1, Census Tract 309.03, Linn County, Oregon",485,142,343,41,043,030903,1
"Block Group 1, Census Tract 309.04, Linn County, Oregon",375,330,45,41,043,030904,1
"Block Group 3, Census Tract 309.04, Linn County, Oregon",556,450,106,41,043,030904,3
"Block Group 3, Census Tract 12.02, Lane County, Oregon",549,285,264,41,039,001202,3
"Block Group 4, Census Tract 15, Lane County, Oregon",518,275,243,41,039,001500,4
"Block Group 1, Census Tract 15, Lane County, Oregon",445,393,52,41,039,001500,1
"Block Group 2, Census Tract 15, Lane County, Oregon",640,365,275,41,039,001500,2
"Block Group 1, Census Tract 18.01, Lane County, Oregon",712,506,206,41,039,001801,1
"Block Group 1, Census Tract 54, Lane County, Oregon",543,377,166,41,039,005400,1
"Block Group 2, Census Tract 43, Lane County, Oregon",632,419,213,41,039,004300,2
"Block Group 4, Census Tract 43, Lane County, Oregon",603,453,150,41,039,004300,4
"Block Group 1, Census Tract 43, Lane County, Oregon",1146,354,792,41,039,004300,1
"Block Group 2, Census Tract 38.01, Multnomah County, Oregon",232,201,31,41,051,003801,2
"Block Group 1, Census Tract 42, Multnomah County, Oregon",653,382,271,41,051,004200,1
"Block Group 3, Census Tract 9703, Wasco County, Oregon",475,305,170,41,065,970300,3
"Block Group 2, Census Tract 9701, Wasco County, Oregon",429,317,112,41,065,970100,2
"Block Group 1, Census Tract 9701, Wasco County, Oregon",879,591,288,41,065,970100,1
"Block Group 3, Census Tract 9701, Wasco County, Oregon",307,272,35,41,065,970100,3
"Block Group 1, Census Tract 9708, Wasco County, Oregon",600,351,249,41,065,970800,1
"Block Group 4, Census Tract 9708, Wasco County, Oregon",636,480,156,41,065,970800,4
"Block Group 3, Census Tract 9708, Wasco County, Oregon",170,114,56,41,065,970800,3
"Block Group 2, Census Tract 9708, Wasco County, Oregon",328,192,136,41,065,970800,2
"Block Group 1, Census Tract 329.01, Washington County, Oregon",1094,933,161,41,067,032901,1
"Block Group 1, Census Tract 4.02, Lane County, Oregon",528,438,90,41,039,000402,1
"Block Group 3, Census Tract 4.02, Lane County, Oregon",554,457,97,41,039,000402,3
"Block Group 2, Census Tract 4.02, Lane County, Oregon",288,267,21,41,039,000402,2
"Block Group 1, Census Tract 44.01, Lane County, Oregon",908,241,667,41,039,004401,1
"Block Group 2, Census Tract 2, Lane County, Oregon",539,474,65,41,039,000200,2
"Block Group 4, Census Tract 2, Lane County, Oregon",573,537,36,41,039,000200,4
"Block Group 1, Census Tract 26, Lane County, Oregon",1087,371,716,41,039,002600,1
"Block Group 3, Census Tract 26, Lane County, Oregon",807,538,269,41,039,002600,3
"Block Group 4, Census Tract 4.03, Lane County, Oregon",536,429,107,41,039,000403,4
"Block Group 1, Census Tract 4.03, Lane County, Oregon",274,239,35,41,039,000403,1
"Block Group 3, Census Tract 4.03, Lane County, Oregon",685,322,363,41,039,000403,3
"Block Group 1, Census Tract 9.04, Lane County, Oregon",374,292,82,41,039,000904,1
"Block Group 2, Census Tract 20.02, Lane County, Oregon",1039,441,598,41,039,002002,2
"Block Group 4, Census Tract 9703, Malheur County, Oregon",467,170,297,41,045,970300,4
"Block Group 1, Census Tract 67.01, Multnomah County, Oregon",696,608,88,41,051,006701,1
"Block Group 1, Census Tract 80.02, Multnomah County, Oregon",582,518,64,41,051,008002,1
"Block Group 2, Census Tract 80.02, Multnomah County, Oregon",499,268,231,41,051,008002,2
"Block Group 1, Census Tract 89.01, Multnomah County, Oregon",1543,1372,171,41,051,008901,1
"Block Group 2, Census Tract 89.01, Multnomah County, Oregon",1117,625,492,41,051,008901,2
"Block Group 3, Census Tract 324.06, Washington County, Oregon",723,332,391,41,067,032406,3
"Block Group 4, Census Tract 324.06, Washington County, Oregon",1167,1069,98,41,067,032406,4
"Block Group 3, Census Tract 326.04, Washington County, Oregon",403,70,333,41,067,032604,3
"Block Group 5, Census Tract 326.04, Washington County, Oregon",719,556,163,41,067,032604,5
"Block Group 4, Census Tract 326.04, Washington County, Oregon",497,433,64,41,067,032604,4
"Block Group 1, Census Tract 326.04, Washington County, Oregon",237,187,50,41,067,032604,1
"Block Group 2, Census Tract 326.04, Washington County, Oregon",452,231,221,41,067,032604,2
"Block Group 2, Census Tract 334, Washington County, Oregon",429,374,55,41,067,033400,2
"Block Group 3, Census Tract 600, Douglas County, Oregon",765,639,126,41,019,060000,3
"Block Group 2, Census Tract 600, Douglas County, Oregon",395,354,41,41,019,060000,2
"Block Group 2, Census Tract 700, Douglas County, Oregon",907,813,94,41,019,070000,2
"Block Group 3, Census Tract 700, Douglas County, Oregon",612,492,120,41,019,070000,3
"Block Group 1, Census Tract 700, Douglas County, Oregon",537,474,63,41,019,070000,1
"Block Group 2, Census Tract 2000, Douglas County, Oregon",396,244,152,41,019,200000,2
"Block Group 4, Census Tract 2000, Douglas County, Oregon",617,265,352,41,019,200000,4
"Block Group 4, Census Tract 9602, Grant County, Oregon",739,458,281,41,023,960200,4
"Block Group 5, Census Tract 9602, Grant County, Oregon",382,240,142,41,023,960200,5
"Block Group 1, Census Tract 33.02, Lane County, Oregon",451,176,275,41,039,003302,1
"Block Group 3, Census Tract 33.02, Lane County, Oregon",562,282,280,41,039,003302,3
"Block Group 1, Census Tract 29.04, Lane County, Oregon",465,0,465,41,039,002904,1
"Block Group 2, Census Tract 29.04, Lane County, Oregon",893,147,746,41,039,002904,2
"Block Group 3, Census Tract 29.04, Lane County, Oregon",827,220,607,41,039,002904,3
"Block Group 3, Census Tract 45.02, Lane County, Oregon",956,274,682,41,039,004502,3
"Block Group 1, Census Tract 320.05, Washington County, Oregon",286,0,286,41,067,032005,1
"Block Group 2, Census Tract 320.05, Washington County, Oregon",500,45,455,41,067,032005,2
"Block Group 4, Census Tract 320.05, Washington County, Oregon",311,0,311,41,067,032005,4
"Block Group 1, Census Tract 308.06, Washington County, Oregon",1051,726,325,41,067,030806,1
"Block Group 1, Census Tract 326.07, Washington County, Oregon",2909,855,2054,41,067,032607,1
"Block Group 1, Census Tract 326.09, Washington County, Oregon",952,477,475,41,067,032609,1
"Block Group 1, Census Tract 331.01, Washington County, Oregon",1110,645,465,41,067,033101,1
"Block Group 1, Census Tract 331.02, Washington County, Oregon",756,363,393,41,067,033102,1
"Block Group 3, Census Tract 332, Washington County, Oregon",1107,101,1006,41,067,033200,3
"Block Group 2, Census Tract 332, Washington County, Oregon",996,546,450,41,067,033200,2
"Block Group 2, Census Tract 319.11, Washington County, Oregon",996,788,208,41,067,031911,2
"Block Group 3, Census Tract 319.10, Washington County, Oregon",1113,598,515,41,067,031910,3
"Block Group 1, Census Tract 45.02, Lane County, Oregon",349,135,214,41,039,004502,1
"Block Group 3, Census Tract 49, Multnomah County, Oregon",940,68,872,41,051,004900,3
"Block Group 3, Census Tract 51, Multnomah County, Oregon",890,202,688,41,051,005100,3
"Block Group 3, Census Tract 52, Multnomah County, Oregon",794,103,691,41,051,005200,3
"Block Group 2, Census Tract 55, Multnomah County, Oregon",758,78,680,41,051,005500,2
"Block Group 2, Census Tract 57, Multnomah County, Oregon",1240,159,1081,41,051,005700,2
"Block Group 3, Census Tract 57, Multnomah County, Oregon",607,174,433,41,051,005700,3
"Block Group 4, Census Tract 91.02, Multnomah County, Oregon",772,686,86,41,051,009102,4
"Block Group 4, Census Tract 303.01, Yamhill County, Oregon",1112,932,180,41,071,030301,4
"Block Group 5, Census Tract 303.01, Yamhill County, Oregon",349,303,46,41,071,030301,5
"Block Group 3, Census Tract 221.01, Clackamas County, Oregon",779,761,18,41,005,022101,3
"Block Group 3, Census Tract 222.01, Clackamas County, Oregon",1030,68,962,41,005,022201,3
"Block Group 5, Census Tract 316.10, Washington County, Oregon",834,206,628,41,067,031610,5
"Block Group 4, Census Tract 98.03, Multnomah County, Oregon",699,16,683,41,051,009803,4
"Block Group 2, Census Tract 20, Deschutes County, Oregon",836,479,357,41,017,002000,2
"Block Group 3, Census Tract 21, Deschutes County, Oregon",2140,1737,403,41,017,002100,3
"Block Group 2, Census Tract 21, Deschutes County, Oregon",1168,572,596,41,017,002100,2
"Block Group 4, Census Tract 21, Deschutes County, Oregon",561,400,161,41,017,002100,4
"Block Group 2, Census Tract 16, Deschutes County, Oregon",1026,241,785,41,017,001600,2
"Block Group 1, Census Tract 16, Deschutes County, Oregon",359,53,306,41,017,001600,1
"Block Group 3, Census Tract 201, Linn County, Oregon",363,326,37,41,043,020100,3
"Block Group 4, Census Tract 201, Linn County, Oregon",973,863,110,41,043,020100,4
"Block Group 1, Census Tract 201, Linn County, Oregon",1914,1293,621,41,043,020100,1
"Block Group 2, Census Tract 206, Linn County, Oregon",654,363,291,41,043,020600,2
"Block Group 3, Census Tract 206, Linn County, Oregon",808,645,163,41,043,020600,3
"Block Group 4, Census Tract 206, Linn County, Oregon",259,208,51,41,043,020600,4
"Block Group 1, Census Tract 304.02, Linn County, Oregon",267,120,147,41,043,030402,1
"Block Group 5, Census Tract 304.02, Linn County, Oregon",603,492,111,41,043,030402,5
"Block Group 2, Census Tract 308, Linn County, Oregon",534,347,187,41,043,030800,2
"Block Group 1, Census Tract 1300, Douglas County, Oregon",568,144,424,41,019,130000,1
"Block Group 5, Census Tract 1300, Douglas County, Oregon",301,86,215,41,019,130000,5
"Block Group 2, Census Tract 1300, Douglas County, Oregon",292,56,236,41,019,130000,2
"Block Group 1, Census Tract 3, Coos County, Oregon",423,167,256,41,011,000300,1
"Block Group 4, Census Tract 3, Coos County, Oregon",443,184,259,41,011,000300,4
"Block Group 3, Census Tract 3, Coos County, Oregon",209,130,79,41,011,000300,3
"Block Group 1, Census Tract 4, Coos County, Oregon",418,221,197,41,011,000400,1
"Block Group 4, Census Tract 4, Coos County, Oregon",361,332,29,41,011,000400,4
"Block Group 6, Census Tract 4, Coos County, Oregon",566,349,217,41,011,000400,6
"Block Group 5, Census Tract 4, Coos County, Oregon",503,235,268,41,011,000400,5
"Block Group 2, Census Tract 4, Coos County, Oregon",236,131,105,41,011,000400,2
"Block Group 3, Census Tract 4, Coos County, Oregon",451,256,195,41,011,000400,3
"Block Group 2, Census Tract 5.02, Coos County, Oregon",349,217,132,41,011,000502,2
"Block Group 1, Census Tract 5.02, Coos County, Oregon",899,754,145,41,011,000502,1
"Block Group 2, Census Tract 9, Coos County, Oregon",576,468,108,41,011,000900,2
"Block Group 1, Census Tract 9, Coos County, Oregon",373,373,0,41,011,000900,1
"Block Group 6, Census Tract 9, Coos County, Oregon",381,336,45,41,011,000900,6
"Block Group 8, Census Tract 9, Coos County, Oregon",199,162,37,41,011,000900,8
"Block Group 4, Census Tract 9, Coos County, Oregon",526,361,165,41,011,000900,4
"Block Group 7, Census Tract 9, Coos County, Oregon",389,271,118,41,011,000900,7
"Block Group 2, Census Tract 9501, Curry County, Oregon",518,311,207,41,015,950100,2
"Block Group 3, Census Tract 9502, Curry County, Oregon",926,662,264,41,015,950200,3
"Block Group 1, Census Tract 9502, Curry County, Oregon",848,578,270,41,015,950200,1
"Block Group 2, Census Tract 9503.01, Curry County, Oregon",378,319,59,41,015,950301,2
"Block Group 1, Census Tract 9503.01, Curry County, Oregon",1031,879,152,41,015,950301,1
"Block Group 1, Census Tract 12.01, Lane County, Oregon",629,480,149,41,039,001201,1
"Block Group 3, Census Tract 12.01, Lane County, Oregon",415,282,133,41,039,001201,3
"Block Group 1, Census Tract 31.02, Lane County, Oregon",504,280,224,41,039,003102,1
"Block Group 2, Census Tract 31.02, Lane County, Oregon",628,438,190,41,039,003102,2
"Block Group 2, Census Tract 37, Lane County, Oregon",0,0,0,41,039,003700,2
"Block Group 2, Census Tract 90, Multnomah County, Oregon",1020,667,353,41,051,009000,2
"Block Group 1, Census Tract 90, Multnomah County, Oregon",1151,549,602,41,051,009000,1
"Block Group 2, Census Tract 92.02, Multnomah County, Oregon",465,286,179,41,051,009202,2
"Block Group 2, Census Tract 93.01, Multnomah County, Oregon",719,324,395,41,051,009301,2
"Block Group 3, Census Tract 93.01, Multnomah County, Oregon",829,59,770,41,051,009301,3
"Block Group 1, Census Tract 98.01, Multnomah County, Oregon",779,242,537,41,051,009801,1
"Block Group 2, Census Tract 84, Multnomah County, Oregon",1044,501,543,41,051,008400,2
"Block Group 1, Census Tract 89.02, Multnomah County, Oregon",981,514,467,41,051,008902,1
"Block Group 2, Census Tract 91.01, Multnomah County, Oregon",867,401,466,41,051,009101,2
"Block Group 1, Census Tract 91.01, Multnomah County, Oregon",1190,536,654,41,051,009101,1
"Block Group 1, Census Tract 104.02, Multnomah County, Oregon",651,494,157,41,051,010402,1
"Block Group 2, Census Tract 104.02, Multnomah County, Oregon",773,555,218,41,051,010402,2
"Block Group 3, Census Tract 104.08, Multnomah County, Oregon",433,85,348,41,051,010408,3
"Block Group 2, Census Tract 104.08, Multnomah County, Oregon",606,495,111,41,051,010408,2
"Block Group 2, Census Tract 9602, Grant County, Oregon",300,191,109,41,023,960200,2
"Block Group 6, Census Tract 308, Linn County, Oregon",676,205,471,41,043,030800,6
"Block Group 4, Census Tract 308, Linn County, Oregon",369,101,268,41,043,030800,4
"Block Group 5, Census Tract 301, Linn County, Oregon",419,403,16,41,043,030100,5
"Block Group 4, Census Tract 301, Linn County, Oregon",471,386,85,41,043,030100,4
"Block Group 2, Census Tract 9602, Tillamook County, Oregon",335,225,110,41,057,960200,2
"Block Group 3, Census Tract 9608, Tillamook County, Oregon",384,348,36,41,057,960800,3
"Block Group 2, Census Tract 9608, Tillamook County, Oregon",261,217,44,41,057,960800,2
"Block Group 3, Census Tract 9606, Tillamook County, Oregon",477,368,109,41,057,960600,3
"Block Group 2, Census Tract 9601, Tillamook County, Oregon",462,369,93,41,057,960100,2
"Block Group 4, Census Tract 9601, Tillamook County, Oregon",334,197,137,41,057,960100,4
"Block Group 3, Census Tract 9601, Tillamook County, Oregon",255,192,63,41,057,960100,3
"Block Group 5, Census Tract 9604, Tillamook County, Oregon",444,223,221,41,057,960400,5
"Block Group 7, Census Tract 9604, Tillamook County, Oregon",483,432,51,41,057,960400,7
"Block Group 4, Census Tract 9604, Tillamook County, Oregon",197,137,60,41,057,960400,4
"Block Group 1, Census Tract 13.01, Lane County, Oregon",473,355,118,41,039,001301,1
"Block Group 3, Census Tract 18.03, Lane County, Oregon",477,207,270,41,039,001803,3
"Block Group 2, Census Tract 18.03, Lane County, Oregon",618,350,268,41,039,001803,2
"Block Group 1, Census Tract 19.04, Lane County, Oregon",954,682,272,41,039,001904,1
"Block Group 2, Census Tract 20.01, Lane County, Oregon",623,530,93,41,039,002001,2
"Block Group 2, Census Tract 22.02, Lane County, Oregon",439,154,285,41,039,002202,2
"Block Group 3, Census Tract 22.02, Lane County, Oregon",1549,691,858,41,039,002202,3
"Block Group 1, Census Tract 38, Lane County, Oregon",403,0,403,41,039,003800,1
"Block Group 4, Census Tract 38, Lane County, Oregon",880,0,880,41,039,003800,4
"Block Group 5, Census Tract 38, Lane County, Oregon",1128,0,1128,41,039,003800,5
"Block Group 1, Census Tract 208.01, Linn County, Oregon",337,132,205,41,043,020801,1
"Block Group 2, Census Tract 9400, Jefferson County, Oregon",476,290,186,41,031,940000,2
"Block Group 1, Census Tract 9400, Jefferson County, Oregon",360,243,117,41,031,940000,1
"Block Group 2, Census Tract 9603.02, Jefferson County, Oregon",330,255,75,41,031,960302,2
"Block Group 3, Census Tract 319.12, Washington County, Oregon",261,187,74,41,067,031912,3
"Block Group 2, Census Tract 319.12, Washington County, Oregon",596,453,143,41,067,031912,2
"Block Group 1, Census Tract 316.16, Washington County, Oregon",663,188,475,41,067,031616,1
"Block Group 2, Census Tract 316.16, Washington County, Oregon",1110,0,1110,41,067,031616,2
"Block Group 3, Census Tract 316.09, Washington County, Oregon",842,712,130,41,067,031609,3
"Block Group 2, Census Tract 316.09, Washington County, Oregon",2638,795,1843,41,067,031609,2
"Block Group 4, Census Tract 316.09, Washington County, Oregon",1017,274,743,41,067,031609,4
"Block Group 2, Census Tract 315.14, Washington County, Oregon",965,794,171,41,067,031514,2
"Block Group 1, Census Tract 315.14, Washington County, Oregon",468,305,163,41,067,031514,1
"Block Group 2, Census Tract 9.02, Multnomah County, Oregon",615,303,312,41,051,000902,2
"Block Group 3, Census Tract 9.02, Multnomah County, Oregon",461,234,227,41,051,000902,3
"Block Group 1, Census Tract 9.02, Multnomah County, Oregon",927,229,698,41,051,000902,1
"Block Group 2, Census Tract 100.01, Multnomah County, Oregon",476,113,363,41,051,010001,2
"Block Group 2, Census Tract 11, Deschutes County, Oregon",724,682,42,41,017,001100,2
"Block Group 1, Census Tract 11, Deschutes County, Oregon",1320,1085,235,41,017,001100,1
"Block Group 2, Census Tract 7, Deschutes County, Oregon",1390,938,452,41,017,000700,2
"Block Group 2, Census Tract 52, Lane County, Oregon",587,492,95,41,039,005200,2
"Block Group 1, Census Tract 35, Lane County, Oregon",337,159,178,41,039,003500,1
"Block Group 1, Census Tract 36, Lane County, Oregon",619,429,190,41,039,003600,1
"Block Group 2, Census Tract 36, Lane County, Oregon",376,369,7,41,039,003600,2
"Block Group 4, Census Tract 36.01, Multnomah County, Oregon",511,349,162,41,051,003601,4
"Block Group 3, Census Tract 36.01, Multnomah County, Oregon",558,342,216,41,051,003601,3
"Block Group 1, Census Tract 36.01, Multnomah County, Oregon",289,229,60,41,051,003601,1
"Block Group 3, Census Tract 40.01, Multnomah County, Oregon",535,228,307,41,051,004001,3
"Block Group 4, Census Tract 40.01, Multnomah County, Oregon",893,604,289,41,051,004001,4
"Block Group 1, Census Tract 52, Multnomah County, Oregon",589,0,589,41,051,005200,1
"Block Group 1, Census Tract 57, Multnomah County, Oregon",605,322,283,41,051,005700,1
"Block Group 1, Census Tract 60.01, Multnomah County, Oregon",446,190,256,41,051,006001,1
"Block Group 2, Census Tract 65.01, Multnomah County, Oregon",855,732,123,41,051,006501,2
"Block Group 2, Census Tract 9706, Wasco County, Oregon",625,487,138,41,065,970600,2
"Block Group 2, Census Tract 9703, Wasco County, Oregon",356,258,98,41,065,970300,2
"Block Group 4, Census Tract 103.06, Marion County, Oregon",384,353,31,41,047,010306,4
"Block Group 5, Census Tract 103.06, Marion County, Oregon",268,194,74,41,047,010306,5
"Block Group 1, Census Tract 103.06, Marion County, Oregon",1439,684,755,41,047,010306,1
"Block Group 3, Census Tract 103.06, Marion County, Oregon",169,42,127,41,047,010306,3
"Block Group 2, Census Tract 103.06, Marion County, Oregon",670,103,567,41,047,010306,2
"Block Group 1, Census Tract 14.02, Marion County, Oregon",563,393,170,41,047,001402,1
"Block Group 2, Census Tract 14.02, Marion County, Oregon",635,351,284,41,047,001402,2
"Block Group 3, Census Tract 14.02, Marion County, Oregon",1110,632,478,41,047,001402,3
"Block Group 4, Census Tract 10.01, Deschutes County, Oregon",1191,684,507,41,017,001001,4
"Block Group 2, Census Tract 10.01, Deschutes County, Oregon",1640,1206,434,41,017,001001,2
"Block Group 3, Census Tract 10.01, Deschutes County, Oregon",487,294,193,41,017,001001,3
"Block Group 1, Census Tract 4.01, Deschutes County, Oregon",1204,798,406,41,017,000401,1
"Block Group 2, Census Tract 4.01, Deschutes County, Oregon",928,671,257,41,017,000401,2
"Block Group 3, Census Tract 7.01, Marion County, Oregon",276,140,136,41,047,000701,3
"Block Group 2, Census Tract 7.01, Marion County, Oregon",682,369,313,41,047,000701,2
"Block Group 1, Census Tract 5.02, Marion County, Oregon",340,75,265,41,047,000502,1
"Block Group 2, Census Tract 5.02, Marion County, Oregon",488,228,260,41,047,000502,2
"Block Group 2, Census Tract 14.01, Marion County, Oregon",562,457,105,41,047,001401,2
"Block Group 2, Census Tract 25.02, Marion County, Oregon",933,675,258,41,047,002502,2
"Block Group 1, Census Tract 25.02, Marion County, Oregon",638,466,172,41,047,002502,1
"Block Group 4, Census Tract 17, Jackson County, Oregon",1423,803,620,41,029,001700,4
"Block Group 3, Census Tract 29.01, Multnomah County, Oregon",481,202,279,41,051,002901,3
"Block Group 1, Census Tract 29.01, Multnomah County, Oregon",356,294,62,41,051,002901,1
"Block Group 2, Census Tract 29.01, Multnomah County, Oregon",389,330,59,41,051,002901,2
"Block Group 2, Census Tract 36.03, Multnomah County, Oregon",370,276,94,41,051,003603,2
"Block Group 2, Census Tract 40.02, Multnomah County, Oregon",361,209,152,41,051,004002,2
"Block Group 3, Census Tract 40.02, Multnomah County, Oregon",572,390,182,41,051,004002,3
"Block Group 4, Census Tract 40.02, Multnomah County, Oregon",417,243,174,41,051,004002,4
"Block Group 3, Census Tract 41.02, Multnomah County, Oregon",518,399,119,41,051,004102,3
"Block Group 2, Census Tract 41.02, Multnomah County, Oregon",379,332,47,41,051,004102,2
"Block Group 1, Census Tract 45, Multnomah County, Oregon",1429,529,900,41,051,004500,1
"Block Group 3, Census Tract 28.02, Multnomah County, Oregon",553,211,342,41,051,002802,3
"Block Group 2, Census Tract 28.02, Multnomah County, Oregon",452,418,34,41,051,002802,2
"Block Group 1, Census Tract 36.02, Multnomah County, Oregon",536,390,146,41,051,003602,1
"Block Group 2, Census Tract 36.02, Multnomah County, Oregon",733,589,144,41,051,003602,2
"Block Group 1, Census Tract 51, Multnomah County, Oregon",3410,918,2492,41,051,005100,1
"Block Group 2, Census Tract 51, Multnomah County, Oregon",1874,372,1502,41,051,005100,2
"Block Group 1, Census Tract 86, Multnomah County, Oregon",783,446,337,41,051,008600,1
"Block Group 2, Census Tract 86, Multnomah County, Oregon",737,484,253,41,051,008600,2
"Block Group 1, Census Tract 71, Multnomah County, Oregon",784,692,92,41,051,007100,1
"Block Group 2, Census Tract 80.01, Multnomah County, Oregon",729,247,482,41,051,008001,2
"Block Group 1, Census Tract 85, Multnomah County, Oregon",1071,580,491,41,051,008500,1
"Block Group 2, Census Tract 306, Washington County, Oregon",774,430,344,41,067,030600,2
"Block Group 3, Census Tract 100.01, Multnomah County, Oregon",1451,540,911,41,051,010001,3
"Block Group 2, Census Tract 4.01, Multnomah County, Oregon",249,179,70,41,051,000401,2
"Block Group 4, Census Tract 4.01, Multnomah County, Oregon",255,233,22,41,051,000401,4
"Block Group 1, Census Tract 4.01, Multnomah County, Oregon",541,402,139,41,051,000401,1
"Block Group 3, Census Tract 4.01, Multnomah County, Oregon",467,321,146,41,051,000401,3
"Block Group 4, Census Tract 41.01, Multnomah County, Oregon",746,413,333,41,051,004101,4
"Block Group 1, Census Tract 41.01, Multnomah County, Oregon",314,242,72,41,051,004101,1
"Block Group 3, Census Tract 41.01, Multnomah County, Oregon",1263,507,756,41,051,004101,3
"Block Group 2, Census Tract 41.01, Multnomah County, Oregon",576,366,210,41,051,004101,2
"Block Group 1, Census Tract 56, Multnomah County, Oregon",1121,110,1011,41,051,005600,1
"Block Group 3, Census Tract 56, Multnomah County, Oregon",520,0,520,41,051,005600,3
"Block Group 1, Census Tract 324.04, Washington County, Oregon",285,274,11,41,067,032404,1
"Block Group 1, Census Tract 314.02, Washington County, Oregon",648,147,501,41,067,031402,1
"Block Group 3, Census Tract 314.04, Washington County, Oregon",908,503,405,41,067,031404,3
"Block Group 4, Census Tract 314.04, Washington County, Oregon",451,353,98,41,067,031404,4
"Block Group 1, Census Tract 315.08, Washington County, Oregon",850,741,109,41,067,031508,1
"Block Group 2, Census Tract 315.08, Washington County, Oregon",596,596,0,41,067,031508,2
"Block Group 2, Census Tract 315.11, Washington County, Oregon",215,177,38,41,067,031511,2
"Block Group 1, Census Tract 318.06, Washington County, Oregon",570,434,136,41,067,031806,1
"Block Group 3, Census Tract 318.06, Washington County, Oregon",900,702,198,41,067,031806,3
"Block Group 4, Census Tract 322, Washington County, Oregon",331,261,70,41,067,032200,4
"Block Group 2, Census Tract 322, Washington County, Oregon",438,416,22,41,067,032200,2
"Block Group 3, Census Tract 322, Washington County, Oregon",408,392,16,41,067,032200,3
"Block Group 1, Census Tract 313, Washington County, Oregon",775,146,629,41,067,031300,1
"Block Group 4, Census Tract 9504, Curry County, Oregon",424,383,41,41,015,950400,4
"Block Group 3, Census Tract 9503.02, Curry County, Oregon",628,257,371,41,015,950302,3
"Block Group 2, Census Tract 82.01, Multnomah County, Oregon",469,405,64,41,051,008201,2
"Block Group 1, Census Tract 96.03, Multnomah County, Oregon",675,487,188,41,051,009603,1
"Block Group 1, Census Tract 102, Multnomah County, Oregon",539,458,81,41,051,010200,1
"Block Group 1, Census Tract 9708, Union County, Oregon",324,270,54,41,061,970800,1
"Block Group 4, Census Tract 9708, Union County, Oregon",439,367,72,41,061,970800,4
"Block Group 2, Census Tract 9706, Union County, Oregon",440,357,83,41,061,970600,2
"Block Group 4, Census Tract 203, Linn County, Oregon",424,266,158,41,043,020300,4
"Block Group 1, Census Tract 203, Linn County, Oregon",300,234,66,41,043,020300,1
"Block Group 2, Census Tract 203, Linn County, Oregon",369,204,165,41,043,020300,2
"Block Group 2, Census Tract 204, Linn County, Oregon",399,163,236,41,043,020400,2
"Block Group 4, Census Tract 204, Linn County, Oregon",512,172,340,41,043,020400,4
"Block Group 2, Census Tract 318.15, Washington County, Oregon",1267,1024,243,41,067,031815,2
"Block Group 1, Census Tract 27, Marion County, Oregon",1146,1023,123,41,047,002700,1
"Block Group 1, Census Tract 205.01, Clackamas County, Oregon",365,304,61,41,005,020501,1
"Block Group 2, Census Tract 207, Clackamas County, Oregon",734,586,148,41,005,020700,2
"Block Group 1, Census Tract 207, Clackamas County, Oregon",289,222,67,41,005,020700,1
"Block Group 1, Census Tract 225, Clackamas County, Oregon",915,456,459,41,005,022500,1
"Block Group 2, Census Tract 225, Clackamas County, Oregon",760,432,328,41,005,022500,2
"Block Group 4, Census Tract 225, Clackamas County, Oregon",269,141,128,41,005,022500,4
"Block Group 3, Census Tract 225, Clackamas County, Oregon",1078,749,329,41,005,022500,3
"Block Group 2, Census Tract 234.01, Clackamas County, Oregon",750,668,82,41,005,023401,2
"Block Group 1, Census Tract 234.01, Clackamas County, Oregon",594,460,134,41,005,023401,1
"Block Group 3, Census Tract 234.01, Clackamas County, Oregon",419,370,49,41,005,023401,3
"Block Group 3, Census Tract 241, Clackamas County, Oregon",515,433,82,41,005,024100,3
"Block Group 1, Census Tract 241, Clackamas County, Oregon",639,597,42,41,005,024100,1
"Block Group 1, Census Tract 206, Clackamas County, Oregon",682,604,78,41,005,020600,1
"Block Group 3, Census Tract 206, Clackamas County, Oregon",1204,883,321,41,005,020600,3
"Block Group 1, Census Tract 203.03, Clackamas County, Oregon",1038,391,647,41,005,020303,1
"Block Group 2, Census Tract 208, Clackamas County, Oregon",419,134,285,41,005,020800,2
"Block Group 3, Census Tract 208, Clackamas County, Oregon",844,374,470,41,005,020800,3
"Block Group 2, Census Tract 221.01, Clackamas County, Oregon",465,345,120,41,005,022101,2
"Block Group 1, Census Tract 221.01, Clackamas County, Oregon",942,577,365,41,005,022101,1
"Block Group 2, Census Tract 9716, Klamath County, Oregon",377,119,258,41,035,971600,2
"Block Group 3, Census Tract 9716, Klamath County, Oregon",535,78,457,41,035,971600,3
"Block Group 3, Census Tract 9712, Klamath County, Oregon",232,212,20,41,035,971200,3
"Block Group 2, Census Tract 9712, Klamath County, Oregon",296,142,154,41,035,971200,2
"Block Group 6, Census Tract 9713, Klamath County, Oregon",324,244,80,41,035,971300,6
"Block Group 3, Census Tract 9713, Klamath County, Oregon",361,75,286,41,035,971300,3
"Block Group 1, Census Tract 9713, Klamath County, Oregon",200,69,131,41,035,971300,1
"Block Group 5, Census Tract 9713, Klamath County, Oregon",798,697,101,41,035,971300,5
"Block Group 2, Census Tract 9709, Klamath County, Oregon",594,410,184,41,035,970900,2
"Block Group 1, Census Tract 9709, Klamath County, Oregon",925,821,104,41,035,970900,1
"Block Group 1, Census Tract 9719, Klamath County, Oregon",314,136,178,41,035,971900,1
"Block Group 4, Census Tract 9719, Klamath County, Oregon",475,86,389,41,035,971900,4
"Block Group 2, Census Tract 42, Multnomah County, Oregon",1263,411,852,41,051,004200,2
"Block Group 3, Census Tract 47, Multnomah County, Oregon",1039,78,961,41,051,004700,3
"Block Group 2, Census Tract 47, Multnomah County, Oregon",753,288,465,41,051,004700,2
"Block Group 1, Census Tract 47, Multnomah County, Oregon",793,383,410,41,051,004700,1
"Block Group 2, Census Tract 65.02, Multnomah County, Oregon",897,644,253,41,051,006502,2
"Block Group 1, Census Tract 65.02, Multnomah County, Oregon",1202,523,679,41,051,006502,1
"Block Group 1, Census Tract 68.02, Multnomah County, Oregon",598,598,0,41,051,006802,1
"Block Group 2, Census Tract 68.02, Multnomah County, Oregon",850,554,296,41,051,006802,2
"Block Group 1, Census Tract 75, Multnomah County, Oregon",780,499,281,41,051,007500,1
"Block Group 3, Census Tract 75, Multnomah County, Oregon",627,377,250,41,051,007500,3
"Block Group 2, Census Tract 75, Multnomah County, Oregon",392,283,109,41,051,007500,2
"Block Group 1, Census Tract 78, Multnomah County, Oregon",369,126,243,41,051,007800,1
"Block Group 2, Census Tract 78, Multnomah County, Oregon",436,365,71,41,051,007800,2
"Block Group 1, Census Tract 88, Multnomah County, Oregon",542,427,115,41,051,008800,1
"Block Group 2, Census Tract 88, Multnomah County, Oregon",556,401,155,41,051,008800,2
"Block Group 3, Census Tract 92.01, Multnomah County, Oregon",1024,408,616,41,051,009201,3
"Block Group 1, Census Tract 98.04, Multnomah County, Oregon",701,438,263,41,051,009804,1
"Block Group 1, Census Tract 99.03, Multnomah County, Oregon",395,358,37,41,051,009903,1
"Block Group 4, Census Tract 316.17, Washington County, Oregon",350,0,350,41,067,031617,4
"Block Group 3, Census Tract 316.17, Washington County, Oregon",542,0,542,41,067,031617,3
"Block Group 2, Census Tract 316.17, Washington County, Oregon",760,14,746,41,067,031617,2
"Block Group 1, Census Tract 316.17, Washington County, Oregon",649,0,649,41,067,031617,1
"Block Group 1, Census Tract 321.10, Washington County, Oregon",672,94,578,41,067,032110,1
"Block Group 1, Census Tract 4.06, Jackson County, Oregon",926,268,658,41,029,000406,1
"Block Group 2, Census Tract 4.06, Jackson County, Oregon",1147,657,490,41,029,000406,2
"Block Group 1, Census Tract 5.02, Jackson County, Oregon",545,344,201,41,029,000502,1
"Block Group 2, Census Tract 5.02, Jackson County, Oregon",784,50,734,41,029,000502,2
"Block Group 3, Census Tract 5.02, Jackson County, Oregon",1125,162,963,41,029,000502,3
"Block Group 2, Census Tract 10.02, Jackson County, Oregon",382,194,188,41,029,001002,2
"Block Group 1, Census Tract 10.02, Jackson County, Oregon",1054,836,218,41,029,001002,1
"Block Group 3, Census Tract 10.02, Jackson County, Oregon",298,34,264,41,029,001002,3
"Block Group 1, Census Tract 4.04, Jackson County, Oregon",884,782,102,41,029,000404,1
"Block Group 2, Census Tract 4.04, Jackson County, Oregon",876,772,104,41,029,000404,2
"Block Group 3, Census Tract 16.02, Jackson County, Oregon",206,191,15,41,029,001602,3
"Block Group 5, Census Tract 16.02, Jackson County, Oregon",874,396,478,41,029,001602,5
"Block Group 1, Census Tract 16.01, Jackson County, Oregon",1489,939,550,41,029,001601,1
"Block Group 2, Census Tract 5.01, Jackson County, Oregon",806,524,282,41,029,000501,2
"Block Group 1, Census Tract 5.01, Jackson County, Oregon",568,151,417,41,029,000501,1
"Block Group 2, Census Tract 4.03, Jackson County, Oregon",279,228,51,41,029,000403,2
"Block Group 2, Census Tract 4.05, Jackson County, Oregon",1076,341,735,41,029,000405,2
"Block Group 1, Census Tract 316.14, Washington County, Oregon",670,612,58,41,067,031614,1
"Block Group 1, Census Tract 324.07, Washington County, Oregon",855,542,313,41,067,032407,1
"Block Group 2, Census Tract 321.08, Washington County, Oregon",571,387,184,41,067,032108,2
"Block Group 3, Census Tract 321.08, Washington County, Oregon",492,471,21,41,067,032108,3
"Block Group 4, Census Tract 333.01, Washington County, Oregon",224,171,53,41,067,033301,4
"Block Group 3, Census Tract 18.01, Lane County, Oregon",518,505,13,41,039,001801,3
"Block Group 3, Census Tract 32.02, Lane County, Oregon",791,194,597,41,039,003202,3
"Block Group 2, Census Tract 9400, Umatilla County, Oregon",677,412,265,41,059,940000,2
"Block Group 2, Census Tract 222.07, Clackamas County, Oregon",521,483,38,41,005,022207,2
"Block Group 1, Census Tract 223.01, Clackamas County, Oregon",600,533,67,41,005,022301,1
"Block Group 2, Census Tract 223.01, Clackamas County, Oregon",576,521,55,41,005,022301,2
"Block Group 1, Census Tract 227.08, Clackamas County, Oregon",519,489,30,41,005,022708,1
"Block Group 2, Census Tract 227.08, Clackamas County, Oregon",1038,594,444,41,005,022708,2
"Block Group 2, Census Tract 223.02, Clackamas County, Oregon",680,658,22,41,005,022302,2
"Block Group 3, Census Tract 223.02, Clackamas County, Oregon",813,510,303,41,005,022302,3
"Block Group 3, Census Tract 226.05, Clackamas County, Oregon",1035,811,224,41,005,022605,3
"Block Group 3, Census Tract 9719, Klamath County, Oregon",235,164,71,41,035,971900,3
"Block Group 4, Census Tract 9720, Klamath County, Oregon",362,200,162,41,035,972000,4
"Block Group 1, Census Tract 9720, Klamath County, Oregon",359,223,136,41,035,972000,1
"Block Group 1, Census Tract 2, Marion County, Oregon",325,133,192,41,047,000200,1
"Block Group 2, Census Tract 2, Marion County, Oregon",408,24,384,41,047,000200,2
"Block Group 3, Census Tract 3, Marion County, Oregon",502,94,408,41,047,000300,3
"Block Group 2, Census Tract 3, Marion County, Oregon",355,173,182,41,047,000300,2
"Block Group 4, Census Tract 3, Marion County, Oregon",507,232,275,41,047,000300,4
"Block Group 2, Census Tract 12, Marion County, Oregon",845,474,371,41,047,001200,2
"Block Group 3, Census Tract 9, Marion County, Oregon",289,120,169,41,047,000900,3
"Block Group 3, Census Tract 1, Coos County, Oregon",585,516,69,41,011,000100,3
"Block Group 4, Census Tract 1, Coos County, Oregon",330,294,36,41,011,000100,4
"Block Group 2, Census Tract 1, Coos County, Oregon",359,283,76,41,011,000100,2
"Block Group 6, Census Tract 1, Coos County, Oregon",386,323,63,41,011,000100,6
"Block Group 1, Census Tract 1, Coos County, Oregon",516,461,55,41,011,000100,1
"Block Group 5, Census Tract 1, Coos County, Oregon",313,212,101,41,011,000100,5
"Block Group 4, Census Tract 13.01, Multnomah County, Oregon",647,182,465,41,051,001301,4
"Block Group 2, Census Tract 13.01, Multnomah County, Oregon",344,162,182,41,051,001301,2
"Block Group 3, Census Tract 13.01, Multnomah County, Oregon",440,226,214,41,051,001301,3
"Block Group 2, Census Tract 14, Multnomah County, Oregon",628,362,266,41,051,001400,2
"Block Group 1, Census Tract 14, Multnomah County, Oregon",691,238,453,41,051,001400,1
"Block Group 5, Census Tract 14, Multnomah County, Oregon",293,132,161,41,051,001400,5
"Block Group 3, Census Tract 14, Multnomah County, Oregon",590,385,205,41,051,001400,3
"Block Group 4, Census Tract 14, Multnomah County, Oregon",371,191,180,41,051,001400,4
"Block Group 4, Census Tract 25.02, Multnomah County, Oregon",562,265,297,41,051,002502,4
"Block Group 3, Census Tract 25.02, Multnomah County, Oregon",904,208,696,41,051,002502,3
"Block Group 3, Census Tract 27.01, Multnomah County, Oregon",295,295,0,41,051,002701,3
"Block Group 1, Census Tract 27.01, Multnomah County, Oregon",428,414,14,41,051,002701,1
"Block Group 1, Census Tract 13.01, Multnomah County, Oregon",507,143,364,41,051,001301,1
"Block Group 1, Census Tract 37.01, Multnomah County, Oregon",477,246,231,41,051,003701,1
"Block Group 4, Census Tract 39.02, Multnomah County, Oregon",365,323,42,41,051,003902,4
"Block Group 2, Census Tract 39.02, Multnomah County, Oregon",394,206,188,41,051,003902,2
"Block Group 3, Census Tract 39.02, Multnomah County, Oregon",341,307,34,41,051,003902,3
"Block Group 2, Census Tract 48, Multnomah County, Oregon",737,64,673,41,051,004800,2
"Block Group 2, Census Tract 49, Multnomah County, Oregon",870,48,822,41,051,004900,2
"Block Group 2, Census Tract 67.02, Multnomah County, Oregon",503,503,0,41,051,006702,2
"Block Group 4, Census Tract 105, Multnomah County, Oregon",324,312,12,41,051,010500,4
"Block Group 2, Census Tract 105, Multnomah County, Oregon",407,374,33,41,051,010500,2
"Block Group 3, Census Tract 105, Multnomah County, Oregon",389,296,93,41,051,010500,3
"Block Group 3, Census Tract 95.02, Multnomah County, Oregon",740,200,540,41,051,009502,3
"Block Group 1, Census Tract 95.02, Multnomah County, Oregon",460,408,52,41,051,009502,1
"Block Group 2, Census Tract 104.07, Multnomah County, Oregon",648,242,406,41,051,010407,2
"Block Group 3, Census Tract 104.07, Multnomah County, Oregon",392,172,220,41,051,010407,3
"Block Group 4, Census Tract 20, Multnomah County, Oregon",892,183,709,41,051,002000,4
"Block Group 3, Census Tract 20, Multnomah County, Oregon",881,227,654,41,051,002000,3
"Block Group 2, Census Tract 317.03, Washington County, Oregon",409,319,90,41,067,031703,2
"Block Group 2, Census Tract 313, Washington County, Oregon",915,366,549,41,067,031300,2
"Block Group 2, Census Tract 320.01, Washington County, Oregon",309,309,0,41,067,032001,2
"Block Group 2, Census Tract 20, Multnomah County, Oregon",397,155,242,41,051,002000,2
"Block Group 1, Census Tract 31, Multnomah County, Oregon",673,370,303,41,051,003100,1
"Block Group 4, Census Tract 31, Multnomah County, Oregon",333,318,15,41,051,003100,4
"Block Group 1, Census Tract 46.02, Multnomah County, Oregon",487,314,173,41,051,004602,1
"Block Group 1, Census Tract 69, Multnomah County, Oregon",636,558,78,41,051,006900,1
"Block Group 2, Census Tract 30, Multnomah County, Oregon",534,476,58,41,051,003000,2
"Block Group 4, Census Tract 30, Multnomah County, Oregon",343,322,21,41,051,003000,4
"Block Group 3, Census Tract 30, Multnomah County, Oregon",599,498,101,41,051,003000,3
"Block Group 2, Census Tract 83.01, Multnomah County, Oregon",953,319,634,41,051,008301,2
"Block Group 1, Census Tract 100.01, Multnomah County, Oregon",535,58,477,41,051,010001,1
"Block Group 2, Census Tract 335, Washington County, Oregon",974,838,136,41,067,033500,2
"Block Group 2, Census Tract 304.01, Washington County, Oregon",907,623,284,41,067,030401,2
"Block Group 1, Census Tract 305.02, Washington County, Oregon",763,547,216,41,067,030502,1
"Block Group 1, Census Tract 312, Washington County, Oregon",663,207,456,41,067,031200,1
"Block Group 3, Census Tract 103.05, Multnomah County, Oregon",380,280,100,41,051,010305,3
"Block Group 2, Census Tract 103.05, Multnomah County, Oregon",574,467,107,41,051,010305,2
"Block Group 1, Census Tract 103.05, Multnomah County, Oregon",514,310,204,41,051,010305,1
"Block Group 2, Census Tract 97.02, Multnomah County, Oregon",722,487,235,41,051,009702,2
"Block Group 1, Census Tract 97.02, Multnomah County, Oregon",803,503,300,41,051,009702,1
"Block Group 4, Census Tract 97.02, Multnomah County, Oregon",809,742,67,41,051,009702,4
"Block Group 3, Census Tract 97.02, Multnomah County, Oregon",362,273,89,41,051,009702,3
"Block Group 1, Census Tract 98.03, Multnomah County, Oregon",866,539,327,41,051,009803,1
"Block Group 2, Census Tract 98.03, Multnomah County, Oregon",578,232,346,41,051,009803,2
"Block Group 1, Census Tract 103.04, Multnomah County, Oregon",759,295,464,41,051,010304,1
"Block Group 2, Census Tract 103.04, Multnomah County, Oregon",521,410,111,41,051,010304,2
"Block Group 1, Census Tract 74, Multnomah County, Oregon",468,238,230,41,051,007400,1
"Block Group 1, Census Tract 304.02, Washington County, Oregon",812,361,451,41,067,030402,1
"Block Group 3, Census Tract 305.01, Washington County, Oregon",768,292,476,41,067,030501,3
"Block Group 1, Census Tract 305.01, Washington County, Oregon",434,276,158,41,067,030501,1
"Block Group 3, Census Tract 38, Lane County, Oregon",860,0,860,41,039,003800,3
"Block Group 3, Census Tract 42, Lane County, Oregon",486,102,384,41,039,004200,3
"Block Group 2, Census Tract 42, Lane County, Oregon",435,61,374,41,039,004200,2
"Block Group 1, Census Tract 42, Lane County, Oregon",626,161,465,41,039,004200,1
"Block Group 1, Census Tract 226.05, Clackamas County, Oregon",586,401,185,41,005,022605,1
"Block Group 2, Census Tract 227.07, Clackamas County, Oregon",2258,1532,726,41,005,022707,2
"Block Group 1, Census Tract 82.01, Multnomah County, Oregon",504,58,446,41,051,008201,1
"Block Group 1, Census Tract 38.03, Multnomah County, Oregon",558,414,144,41,051,003803,1
"Block Group 2, Census Tract 46.01, Multnomah County, Oregon",682,482,200,41,051,004601,2
"Block Group 1, Census Tract 46.01, Multnomah County, Oregon",849,780,69,41,051,004601,1
"Block Group 3, Census Tract 63, Multnomah County, Oregon",659,511,148,41,051,006300,3
"Block Group 2, Census Tract 102, Multnomah County, Oregon",878,533,345,41,051,010200,2
"Block Group 2, Census Tract 32, Multnomah County, Oregon",436,281,155,41,051,003200,2
"Block Group 4, Census Tract 32, Multnomah County, Oregon",576,553,23,41,051,003200,4
"Block Group 1, Census Tract 33.02, Multnomah County, Oregon",500,352,148,41,051,003302,1
"Block Group 4, Census Tract 34.01, Multnomah County, Oregon",495,168,327,41,051,003401,4
"Block Group 1, Census Tract 34.01, Multnomah County, Oregon",416,258,158,41,051,003401,1
"Block Group 2, Census Tract 34.01, Multnomah County, Oregon",433,207,226,41,051,003401,2
"Block Group 3, Census Tract 3.02, Multnomah County, Oregon",349,293,56,41,051,000302,3
"Block Group 3, Census Tract 7, Deschutes County, Oregon",447,436,11,41,017,000700,3
"Block Group 4, Census Tract 8, Deschutes County, Oregon",331,170,161,41,017,000800,4
"Block Group 1, Census Tract 8, Deschutes County, Oregon",1690,1461,229,41,017,000800,1
"Block Group 2, Census Tract 8, Deschutes County, Oregon",451,206,245,41,017,000800,2
"Block Group 3, Census Tract 8, Deschutes County, Oregon",356,172,184,41,017,000800,3
"Block Group 4, Census Tract 9, Jackson County, Oregon",1747,952,795,41,029,000900,4
"Block Group 3, Census Tract 14, Jackson County, Oregon",1718,1298,420,41,029,001400,3
"Block Group 2, Census Tract 321.10, Washington County, Oregon",308,278,30,41,067,032110,2
"Block Group 1, Census Tract 321.09, Washington County, Oregon",335,332,3,41,067,032109,1
"Block Group 2, Census Tract 321.09, Washington County, Oregon",691,618,73,41,067,032109,2
"Block Group 3, Census Tract 320.03, Washington County, Oregon",300,36,264,41,067,032003,3
"Block Group 1, Census Tract 320.03, Washington County, Oregon",960,193,767,41,067,032003,1
"Block Group 2, Census Tract 320.03, Washington County, Oregon",776,216,560,41,067,032003,2
"Block Group 2, Census Tract 320.04, Washington County, Oregon",399,212,187,41,067,032004,2
"Block Group 1, Census Tract 320.04, Washington County, Oregon",433,364,69,41,067,032004,1
"Block Group 1, Census Tract 319.10, Washington County, Oregon",1499,1289,210,41,067,031910,1
"Block Group 2, Census Tract 319.10, Washington County, Oregon",576,560,16,41,067,031910,2
"Block Group 1, Census Tract 308.05, Washington County, Oregon",498,479,19,41,067,030805,1
"Block Group 3, Census Tract 308.05, Washington County, Oregon",866,276,590,41,067,030805,3
"Block Group 1, Census Tract 319.07, Washington County, Oregon",686,582,104,41,067,031907,1
"Block Group 5, Census Tract 319.07, Washington County, Oregon",738,557,181,41,067,031907,5
"Block Group 2, Census Tract 9, Deschutes County, Oregon",560,304,256,41,017,000900,2
"Block Group 3, Census Tract 9, Deschutes County, Oregon",687,265,422,41,017,000900,3
"Block Group 2, Census Tract 18, Deschutes County, Oregon",1131,888,243,41,017,001800,2
"Block Group 3, Census Tract 18, Deschutes County, Oregon",1197,240,957,41,017,001800,3
"Block Group 2, Census Tract 305.01, Washington County, Oregon",534,419,115,41,067,030501,2
"Block Group 2, Census Tract 307, Washington County, Oregon",352,83,269,41,067,030700,2
"Block Group 1, Census Tract 315.04, Washington County, Oregon",580,498,82,41,067,031504,1
"Block Group 2, Census Tract 315.04, Washington County, Oregon",374,320,54,41,067,031504,2
"Block Group 1, Census Tract 315.06, Washington County, Oregon",449,449,0,41,067,031506,1
"Block Group 2, Census Tract 315.06, Washington County, Oregon",1051,412,639,41,067,031506,2
"Block Group 2, Census Tract 317.05, Washington County, Oregon",816,481,335,41,067,031705,2
"Block Group 3, Census Tract 317.05, Washington County, Oregon",587,279,308,41,067,031705,3
"Block Group 2, Census Tract 10.01, Lane County, Oregon",564,539,25,41,039,001001,2
"Block Group 1, Census Tract 10.01, Lane County, Oregon",491,401,90,41,039,001001,1
"Block Group 1, Census Tract 10.02, Lane County, Oregon",628,518,110,41,039,001002,1
"Block Group 3, Census Tract 10.02, Lane County, Oregon",490,394,96,41,039,001002,3
"Block Group 2, Census Tract 18.04, Lane County, Oregon",1015,885,130,41,039,001804,2
"Block Group 2, Census Tract 19.02, Lane County, Oregon",261,170,91,41,039,001902,2
"Block Group 1, Census Tract 22.01, Lane County, Oregon",592,554,38,41,039,002201,1
"Block Group 2, Census Tract 22.01, Lane County, Oregon",1044,653,391,41,039,002201,2
"Block Group 1, Census Tract 4.04, Lane County, Oregon",421,313,108,41,039,000404,1
"Block Group 3, Census Tract 4.04, Lane County, Oregon",629,281,348,41,039,000404,3
"Block Group 1, Census Tract 7.02, Lane County, Oregon",613,440,173,41,039,000702,1
"Block Group 3, Census Tract 9.02, Lane County, Oregon",561,506,55,41,039,000902,3
"Block Group 1, Census Tract 9.02, Lane County, Oregon",326,269,57,41,039,000902,1
"Block Group 1, Census Tract 9703, Malheur County, Oregon",313,164,149,41,045,970300,1
"Block Group 3, Census Tract 9703, Malheur County, Oregon",258,111,147,41,045,970300,3
"Block Group 5, Census Tract 9703, Malheur County, Oregon",426,183,243,41,045,970300,5
"Block Group 4, Census Tract 9704, Malheur County, Oregon",242,107,135,41,045,970400,4
"Block Group 5, Census Tract 9704, Malheur County, Oregon",272,122,150,41,045,970400,5
"Block Group 2, Census Tract 46, Lane County, Oregon",518,344,174,41,039,004600,2
"Block Group 3, Census Tract 46, Lane County, Oregon",242,205,37,41,039,004600,3
"Block Group 1, Census Tract 51, Lane County, Oregon",704,247,457,41,039,005100,1
"Block Group 2, Census Tract 51, Lane County, Oregon",801,477,324,41,039,005100,2
"Block Group 1, Census Tract 9602, Wallowa County, Oregon",584,417,167,41,063,960200,1
"Block Group 2, Census Tract 9602, Wallowa County, Oregon",244,181,63,41,063,960200,2
"Block Group 1, Census Tract 9603, Wallowa County, Oregon",367,264,103,41,063,960300,1
"Block Group 4, Census Tract 9603, Wallowa County, Oregon",300,193,107,41,063,960300,4
"Block Group 3, Census Tract 9603, Wallowa County, Oregon",589,364,225,41,063,960300,3
"Block Group 2, Census Tract 9603, Wallowa County, Oregon",212,150,62,41,063,960300,2
"Block Group 2, Census Tract 327, Washington County, Oregon",963,789,174,41,067,032700,2
"Block Group 3, Census Tract 327, Washington County, Oregon",689,595,94,41,067,032700,3
"Block Group 2, Census Tract 318.04, Washington County, Oregon",1374,1093,281,41,067,031804,2
"Block Group 1, Census Tract 321.04, Washington County, Oregon",319,303,16,41,067,032104,1
"Block Group 1, Census Tract 50, Multnomah County, Oregon",2508,716,1792,41,051,005000,1
"Block Group 1, Census Tract 61, Multnomah County, Oregon",523,497,26,41,051,006100,1
"Block Group 1, Census Tract 62, Multnomah County, Oregon",469,375,94,41,051,006200,1
"Block Group 1, Census Tract 66.01, Multnomah County, Oregon",669,468,201,41,051,006601,1
"Block Group 2, Census Tract 104.05, Multnomah County, Oregon",328,210,118,41,051,010405,2
"Block Group 3, Census Tract 104.05, Multnomah County, Oregon",685,144,541,41,051,010405,3
"Block Group 2, Census Tract 9503.02, Curry County, Oregon",859,653,206,41,015,950302,2
"Block Group 1, Census Tract 9503.02, Curry County, Oregon",507,252,255,41,015,950302,1
"Block Group 2, Census Tract 9601, Gilliam County, Oregon",246,173,73,41,021,960100,2
"Block Group 3, Census Tract 9601, Gilliam County, Oregon",242,191,51,41,021,960100,3
"Block Group 3, Census Tract 9501, Hood River County, Oregon",251,184,67,41,027,950100,3
"Block Group 1, Census Tract 9501, Hood River County, Oregon",546,331,215,41,027,950100,1
"Block Group 3, Census Tract 9502, Hood River County, Oregon",485,449,36,41,027,950200,3
"Block Group 5, Census Tract 9502, Hood River County, Oregon",511,440,71,41,027,950200,5
"Block Group 3, Census Tract 9503, Hood River County, Oregon",370,235,135,41,027,950300,3
"Block Group 1, Census Tract 9503, Hood River County, Oregon",285,165,120,41,027,950300,1
"Block Group 2, Census Tract 9503, Hood River County, Oregon",615,269,346,41,027,950300,2
"Block Group 5, Census Tract 9503, Hood River County, Oregon",338,91,247,41,027,950300,5
"Block Group 1, Census Tract 9504, Hood River County, Oregon",488,289,199,41,027,950400,1
"Block Group 2, Census Tract 9504, Hood River County, Oregon",511,384,127,41,027,950400,2
"Block Group 3, Census Tract 10.01, Benton County, Oregon",605,230,375,41,003,001001,3
"Block Group 1, Census Tract 10.01, Benton County, Oregon",559,317,242,41,003,001001,1
"Block Group 3, Census Tract 11.02, Benton County, Oregon",407,132,275,41,003,001102,3
"Block Group 4, Census Tract 11.02, Benton County, Oregon",426,0,426,41,003,001102,4
"Block Group 1, Census Tract 1, Deschutes County, Oregon",813,758,55,41,017,000100,1
"Block Group 2, Census Tract 2, Deschutes County, Oregon",484,339,145,41,017,000200,2
"Block Group 1, Census Tract 2, Deschutes County, Oregon",800,703,97,41,017,000200,1
"Block Group 3, Census Tract 3, Deschutes County, Oregon",474,419,55,41,017,000300,3
"Block Group 1, Census Tract 3, Deschutes County, Oregon",1300,929,371,41,017,000300,1
"Block Group 2, Census Tract 3, Deschutes County, Oregon",1057,734,323,41,017,000300,2
"Block Group 3, Census Tract 5, Deschutes County, Oregon",428,394,34,41,017,000500,3
"Block Group 1, Census Tract 5, Deschutes County, Oregon",669,473,196,41,017,000500,1
"Block Group 3, Census Tract 6, Deschutes County, Oregon",525,416,109,41,017,000600,3
"Block Group 1, Census Tract 7.05, Lane County, Oregon",337,161,176,41,039,000705,1
"Block Group 2, Census Tract 7.05, Lane County, Oregon",952,593,359,41,039,000705,2
"Block Group 1, Census Tract 25.03, Lane County, Oregon",1484,1211,273,41,039,002503,1
"Block Group 4, Census Tract 25.03, Lane County, Oregon",68,68,0,41,039,002503,4
"Block Group 3, Census Tract 25.03, Lane County, Oregon",899,424,475,41,039,002503,3
"Block Group 3, Census Tract 44.04, Lane County, Oregon",550,358,192,41,039,004404,3
"Block Group 1, Census Tract 44.04, Lane County, Oregon",417,369,48,41,039,004404,1
"Block Group 1, Census Tract 9602.02, Jefferson County, Oregon",457,250,207,41,031,960202,1
"Block Group 3, Census Tract 310.04, Washington County, Oregon",546,519,27,41,067,031004,3
"Block Group 2, Census Tract 310.04, Washington County, Oregon",581,503,78,41,067,031004,2
"Block Group 1, Census Tract 310.04, Washington County, Oregon",768,391,377,41,067,031004,1
"Block Group 1, Census Tract 311, Washington County, Oregon",897,275,622,41,067,031100,1
"Block Group 2, Census Tract 311, Washington County, Oregon",365,102,263,41,067,031100,2
"Block Group 1, Census Tract 314.03, Washington County, Oregon",305,175,130,41,067,031403,1
"Block Group 2, Census Tract 314.03, Washington County, Oregon",931,463,468,41,067,031403,2
"Block Group 3, Census Tract 314.03, Washington County, Oregon",676,460,216,41,067,031403,3
"Block Group 1, Census Tract 315.07, Washington County, Oregon",1036,955,81,41,067,031507,1
"Block Group 2, Census Tract 315.07, Washington County, Oregon",388,340,48,41,067,031507,2
"Block Group 3, Census Tract 315.07, Washington County, Oregon",828,314,514,41,067,031507,3
"Block Group 3, Census Tract 4, Marion County, Oregon",411,19,392,41,047,000400,3
"Block Group 5, Census Tract 16.02, Marion County, Oregon",718,51,667,41,047,001602,5
"Block Group 4, Census Tract 31.02, Lane County, Oregon",1164,220,944,41,039,003102,4
"Block Group 3, Census Tract 205.01, Clackamas County, Oregon",1082,992,90,41,005,020501,3
"Block Group 2, Census Tract 205.04, Clackamas County, Oregon",913,887,26,41,005,020504,2
"Block Group 1, Census Tract 205.04, Clackamas County, Oregon",386,330,56,41,005,020504,1
"Block Group 3, Census Tract 207, Clackamas County, Oregon",422,386,36,41,005,020700,3
"Block Group 4, Census Tract 211, Clackamas County, Oregon",693,486,207,41,005,021100,4
"Block Group 2, Census Tract 215, Clackamas County, Oregon",1256,787,469,41,005,021500,2
"Block Group 1, Census Tract 13, Deschutes County, Oregon",2442,1463,979,41,017,001300,1
"Block Group 2, Census Tract 13, Deschutes County, Oregon",1852,1545,307,41,017,001300,2
"Block Group 5, Census Tract 13, Deschutes County, Oregon",382,282,100,41,017,001300,5
"Block Group 4, Census Tract 13, Deschutes County, Oregon",352,67,285,41,017,001300,4
"Block Group 1, Census Tract 14, Deschutes County, Oregon",2236,1488,748,41,017,001400,1
"Block Group 3, Census Tract 14, Deschutes County, Oregon",260,164,96,41,017,001400,3
"Block Group 3, Census Tract 15, Deschutes County, Oregon",885,453,432,41,017,001500,3
"Block Group 5, Census Tract 15, Deschutes County, Oregon",794,341,453,41,017,001500,5
"Block Group 1, Census Tract 15, Deschutes County, Oregon",227,107,120,41,017,001500,1
"Block Group 3, Census Tract 17, Deschutes County, Oregon",454,327,127,41,017,001700,3
"Block Group 1, Census Tract 17, Deschutes County, Oregon",1344,775,569,41,017,001700,1
"Block Group 1, Census Tract 9702, Union County, Oregon",413,303,110,41,061,970200,1
"Block Group 3, Census Tract 9702, Union County, Oregon",390,278,112,41,061,970200,3
"Block Group 2, Census Tract 9705, Union County, Oregon",466,197,269,41,061,970500,2
"Block Group 1, Census Tract 9705, Union County, Oregon",399,209,190,41,061,970500,1
"Block Group 1, Census Tract 9701, Union County, Oregon",322,277,45,41,061,970100,1
"Block Group 4, Census Tract 9701, Union County, Oregon",286,246,40,41,061,970100,4
"Block Group 2, Census Tract 9701, Union County, Oregon",534,388,146,41,061,970100,2
"Block Group 2, Census Tract 305, Linn County, Oregon",794,673,121,41,043,030500,2
"Block Group 1, Census Tract 305, Linn County, Oregon",368,309,59,41,043,030500,1
"Block Group 3, Census Tract 207, Linn County, Oregon",770,427,343,41,043,020700,3
"Block Group 1, Census Tract 207, Linn County, Oregon",893,477,416,41,043,020700,1
"Block Group 2, Census Tract 207, Linn County, Oregon",494,379,115,41,043,020700,2
"Block Group 3, Census Tract 800, Douglas County, Oregon",424,272,152,41,019,080000,3
"Block Group 1, Census Tract 800, Douglas County, Oregon",1473,949,524,41,019,080000,1
"Block Group 1, Census Tract 1400, Douglas County, Oregon",401,377,24,41,019,140000,1
"Block Group 2, Census Tract 1400, Douglas County, Oregon",544,283,261,41,019,140000,2
"Block Group 5, Census Tract 1400, Douglas County, Oregon",436,145,291,41,019,140000,5
"Block Group 4, Census Tract 1400, Douglas County, Oregon",471,175,296,41,019,140000,4
"Block Group 3, Census Tract 1400, Douglas County, Oregon",724,311,413,41,019,140000,3
"Block Group 5, Census Tract 1600, Douglas County, Oregon",528,374,154,41,019,160000,5
"Block Group 1, Census Tract 1600, Douglas County, Oregon",633,450,183,41,019,160000,1
"Block Group 3, Census Tract 1600, Douglas County, Oregon",726,488,238,41,019,160000,3
"Block Group 4, Census Tract 1600, Douglas County, Oregon",332,97,235,41,019,160000,4
"Block Group 3, Census Tract 1900, Douglas County, Oregon",379,323,56,41,019,190000,3
"Block Group 1, Census Tract 1900, Douglas County, Oregon",989,705,284,41,019,190000,1
"Block Group 4, Census Tract 200, Douglas County, Oregon",187,144,43,41,019,020000,4
"Block Group 3, Census Tract 200, Douglas County, Oregon",636,309,327,41,019,020000,3
"Block Group 1, Census Tract 1100, Douglas County, Oregon",418,347,71,41,019,110000,1
"Block Group 3, Census Tract 1100, Douglas County, Oregon",265,253,12,41,019,110000,3
"Block Group 1, Census Tract 2100, Douglas County, Oregon",232,165,67,41,019,210000,1
"Block Group 5, Census Tract 302, Linn County, Oregon",476,389,87,41,043,030200,5
"Block Group 6, Census Tract 302, Linn County, Oregon",509,459,50,41,043,030200,6
"Block Group 2, Census Tract 302, Linn County, Oregon",344,154,190,41,043,030200,2
"Block Group 3, Census Tract 303, Linn County, Oregon",253,192,61,41,043,030300,3
"Block Group 1, Census Tract 303, Linn County, Oregon",308,227,81,41,043,030300,1
"Block Group 5, Census Tract 304.01, Linn County, Oregon",203,187,16,41,043,030401,5
"Block Group 2, Census Tract 304.01, Linn County, Oregon",731,603,128,41,043,030401,2
"Block Group 4, Census Tract 9, Marion County, Oregon",369,72,297,41,047,000900,4
"Block Group 1, Census Tract 9, Marion County, Oregon",483,184,299,41,047,000900,1
"Block Group 2, Census Tract 9, Marion County, Oregon",329,119,210,41,047,000900,2
"Block Group 6, Census Tract 9, Marion County, Oregon",265,212,53,41,047,000900,6
"Block Group 7, Census Tract 9, Marion County, Oregon",325,26,299,41,047,000900,7
"Block Group 5, Census Tract 9, Marion County, Oregon",183,77,106,41,047,000900,5
"Block Group 1, Census Tract 15.02, Marion County, Oregon",859,362,497,41,047,001502,1
"Block Group 2, Census Tract 15.02, Marion County, Oregon",689,242,447,41,047,001502,2
"Block Group 3, Census Tract 15.02, Marion County, Oregon",380,319,61,41,047,001502,3
"Block Group 2, Census Tract 9601, Grant County, Oregon",173,139,34,41,023,960100,2
"Block Group 1, Census Tract 9601, Grant County, Oregon",387,248,139,41,023,960100,1
"Block Group 3, Census Tract 9601, Grant County, Oregon",349,293,56,41,023,960100,3
"Block Group 2, Census Tract 9601, Jefferson County, Oregon",397,285,112,41,031,960100,2
"Block Group 1, Census Tract 9601, Jefferson County, Oregon",213,166,47,41,031,960100,1
"Block Group 3, Census Tract 52.02, Polk County, Oregon",1186,874,312,41,053,005202,3
"Block Group 2, Census Tract 52.02, Polk County, Oregon",1005,149,856,41,053,005202,2
"Block Group 2, Census Tract 53, Polk County, Oregon",619,531,88,41,053,005300,2
"Block Group 4, Census Tract 53, Polk County, Oregon",593,559,34,41,053,005300,4
"Block Group 3, Census Tract 53, Polk County, Oregon",1071,651,420,41,053,005300,3
"Block Group 2, Census Tract 314.04, Washington County, Oregon",298,255,43,41,067,031404,2
"Block Group 1, Census Tract 9504, Curry County, Oregon",651,563,88,41,015,950400,1
"Block Group 1, Census Tract 204, Linn County, Oregon",289,230,59,41,043,020400,1
"Block Group 1, Census Tract 16.02, Jackson County, Oregon",517,351,166,41,029,001602,1
"Block Group 4, Census Tract 326.03, Washington County, Oregon",1007,723,284,41,067,032603,4
"Block Group 1, Census Tract 226.03, Clackamas County, Oregon",1512,806,706,41,005,022603,1
"Block Group 1, Census Tract 1500, Douglas County, Oregon",963,901,62,41,019,150000,1
"Block Group 1, Census Tract 35.02, Multnomah County, Oregon",590,132,458,41,051,003502,1
"Block Group 3, Census Tract 235, Clackamas County, Oregon",359,279,80,41,005,023500,3
"Block Group 1, Census Tract 6.02, Jackson County, Oregon",911,377,534,41,029,000602,1
"Block Group 5, Census Tract 18.02, Marion County, Oregon",569,367,202,41,047,001802,5
"Block Group 2, Census Tract 243.02, Clackamas County, Oregon",646,487,159,41,005,024302,2
"Block Group 1, Census Tract 205, Polk County, Oregon",529,375,154,41,053,020500,1
"Block Group 2, Census Tract 306.02, Yamhill County, Oregon",1135,934,201,41,071,030602,2
"Block Group 4, Census Tract 3616, Josephine County, Oregon",543,324,219,41,033,361600,4
"Block Group 2, Census Tract 11, Marion County, Oregon",915,502,413,41,047,001100,2
"Block Group 2, Census Tract 9505, Clatsop County, Oregon",310,216,94,41,007,950500,2
"Block Group 2, Census Tract 28.01, Multnomah County, Oregon",606,442,164,41,051,002801,2
"Block Group 3, Census Tract 12.01, Multnomah County, Oregon",454,61,393,41,051,001201,3
"Block Group 1, Census Tract 9800, Clackamas County, Oregon",11,0,11,41,005,980000,1
"Block Group 2, Census Tract 109, Benton County, Oregon",1219,625,594,41,003,010900,2
"Block Group 2, Census Tract 44.05, Lane County, Oregon",542,385,157,41,039,004405,2
"Block Group 2, Census Tract 226.02, Clackamas County, Oregon",818,759,59,41,005,022602,2
"Block Group 1, Census Tract 3603, Josephine County, Oregon",585,499,86,41,033,360300,1
"Block Group 2, Census Tract 27, Marion County, Oregon",447,298,149,41,047,002700,2
"Block Group 1, Census Tract 9510, Lincoln County, Oregon",349,159,190,41,041,951000,1
"Block Group 3, Census Tract 201, Clackamas County, Oregon",405,206,199,41,005,020100,3
"Block Group 4, Census Tract 9505, Umatilla County, Oregon",346,318,28,41,059,950500,4
"Block Group 3, Census Tract 315.14, Washington County, Oregon",1299,625,674,41,067,031514,3
"Block Group 2, Census Tract 318.14, Washington County, Oregon",1022,881,141,41,067,031814,2
"Block Group 2, Census Tract 9511, Clatsop County, Oregon",316,231,85,41,007,951100,2
"Block Group 1, Census Tract 109, Benton County, Oregon",977,886,91,41,003,010900,1
"Block Group 3, Census Tract 217, Clackamas County, Oregon",1028,381,647,41,005,021700,3
"Block Group 4, Census Tract 7, Deschutes County, Oregon",567,403,164,41,017,000700,4
"Block Group 4, Census Tract 9716, Klamath County, Oregon",411,149,262,41,035,971600,4
"Block Group 5, Census Tract 9719, Klamath County, Oregon",127,33,94,41,035,971900,5
"Block Group 2, Census Tract 37.01, Multnomah County, Oregon",562,288,274,41,051,003701,2
"Block Group 2, Census Tract 38.03, Multnomah County, Oregon",764,232,532,41,051,003803,2
"Block Group 4, Census Tract 9, Deschutes County, Oregon",760,277,483,41,017,000900,4
"Block Group 4, Census Tract 5, Deschutes County, Oregon",845,419,426,41,017,000500,4
"Block Group 3, Census Tract 9607, Tillamook County, Oregon",266,166,100,41,057,960700,3
"Block Group 1, Census Tract 202.02, Polk County, Oregon",938,836,102,41,053,020202,1
"Block Group 2, Census Tract 9501, Crook County, Oregon",638,453,185,41,013,950100,2
"Block Group 1, Census Tract 9702, Wasco County, Oregon",303,198,105,41,065,970200,1
"Block Group 1, Census Tract 8, Coos County, Oregon",484,409,75,41,011,000800,1
"Block Group 2, Census Tract 9601, Harney County, Oregon",392,270,122,41,025,960100,2
"Block Group 1, Census Tract 99.06, Multnomah County, Oregon",862,715,147,41,051,009906,1
"Block Group 1, Census Tract 305.02, Yamhill County, Oregon",519,358,161,41,071,030502,1
"Block Group 3, Census Tract 16.03, Marion County, Oregon",378,225,153,41,047,001603,3
"Block Group 4, Census Tract 59, Multnomah County, Oregon",912,196,716,41,051,005900,4
"Block Group 1, Census Tract 19.03, Lane County, Oregon",759,394,365,41,039,001903,1
"Block Group 3, Census Tract 10, Coos County, Oregon",483,194,289,41,011,001000,3
"Block Group 1, Census Tract 239.02, Clackamas County, Oregon",952,556,396,41,005,023902,1
"Block Group 2, Census Tract 329.01, Washington County, Oregon",822,495,327,41,067,032901,2
"Block Group 2, Census Tract 310.05, Washington County, Oregon",667,426,241,41,067,031005,2
"Block Group 1, Census Tract 32.02, Lane County, Oregon",539,300,239,41,039,003202,1
"Block Group 2, Census Tract 54, Lane County, Oregon",529,361,168,41,039,005400,2
"Block Group 2, Census Tract 24.03, Lane County, Oregon",463,429,34,41,039,002403,2
"Block Group 2, Census Tract 98.01, Multnomah County, Oregon",763,251,512,41,051,009801,2
"Block Group 3, Census Tract 25.01, Marion County, Oregon",1464,794,670,41,047,002501,3
"Block Group 3, Census Tract 500.02, Douglas County, Oregon",778,471,307,41,019,050002,3
"Block Group 4, Census Tract 309.02, Linn County, Oregon",351,336,15,41,043,030902,4
"Block Group 2, Census Tract 304.02, Linn County, Oregon",1022,626,396,41,043,030402,2
"Block Group 3, Census Tract 9501, Curry County, Oregon",435,352,83,41,015,950100,3
"Block Group 2, Census Tract 35, Lane County, Oregon",520,404,116,41,039,003500,2
"Block Group 2, Census Tract 9704, Wasco County, Oregon",771,414,357,41,065,970400,2
"Block Group 3, Census Tract 2000, Douglas County, Oregon",566,487,79,41,019,200000,3
"Block Group 1, Census Tract 46, Lane County, Oregon",502,268,234,41,039,004600,1
"Block Group 2, Census Tract 1500, Douglas County, Oregon",1217,696,521,41,019,150000,2
"Block Group 3, Census Tract 27, Marion County, Oregon",543,451,92,41,047,002700,3
"Block Group 3, Census Tract 202.02, Polk County, Oregon",920,236,684,41,053,020202,3
"Block Group 1, Census Tract 16.04, Marion County, Oregon",911,159,752,41,047,001604,1
"Block Group 4, Census Tract 30.01, Jackson County, Oregon",303,230,73,41,029,003001,4
"Block Group 2, Census Tract 9501, Umatilla County, Oregon",252,193,59,41,059,950100,2
"Block Group 2, Census Tract 92.01, Multnomah County, Oregon",1136,621,515,41,051,009201,2
"Block Group 3, Census Tract 31, Multnomah County, Oregon",398,362,36,41,051,003100,3
"Block Group 2, Census Tract 305.02, Washington County, Oregon",373,203,170,41,067,030502,2
"Block Group 4, Census Tract 315.04, Washington County, Oregon",1006,594,412,41,067,031504,4
"Block Group 1, Census Tract 19.02, Lane County, Oregon",762,269,493,41,039,001902,1
"Block Group 1, Census Tract 9704, Malheur County, Oregon",515,151,364,41,045,970400,1
"Block Group 5, Census Tract 9702, Morrow County, Oregon",170,151,19,41,049,970200,5
"Block Group 1, Census Tract 3.01, Multnomah County, Oregon",613,260,353,41,051,000301,1
"Block Group 3, Census Tract 81, Multnomah County, Oregon",482,100,382,41,051,008100,3
"Block Group 3, Census Tract 8.01, Multnomah County, Oregon",526,291,235,41,051,000801,3
"Block Group 1, Census Tract 83.02, Multnomah County, Oregon",749,487,262,41,051,008302,1
"Block Group 6, Census Tract 317.04, Washington County, Oregon",1045,818,227,41,067,031704,6
"Block Group 2, Census Tract 9603, Tillamook County, Oregon",771,602,169,41,057,960300,2
"Block Group 1, Census Tract 27.02, Multnomah County, Oregon",696,297,399,41,051,002702,1
"Block Group 4, Census Tract 12, Deschutes County, Oregon",1313,1064,249,41,017,001200,4
"Block Group 1, Census Tract 301, Linn County, Oregon",453,291,162,41,043,030100,1
"Block Group 4, Census Tract 237, Clackamas County, Oregon",490,474,16,41,005,023700,4
"Block Group 2, Census Tract 205.03, Clackamas County, Oregon",418,342,76,41,005,020503,2
"Block Group 2, Census Tract 13.01, Jackson County, Oregon",70,62,8,41,029,001301,2
"Block Group 2, Census Tract 26, Jackson County, Oregon",541,412,129,41,029,002600,2
"Block Group 1, Census Tract 9714, Klamath County, Oregon",323,232,91,41,035,971400,1
"Block Group 1, Census Tract 219, Clackamas County, Oregon",986,354,632,41,005,021900,1
"Block Group 2, Census Tract 9502, Baker County, Oregon",450,273,177,41,001,950200,2
"Block Group 3, Census Tract 13.01, Lane County, Oregon",338,290,48,41,039,001301,3
"Block Group 3, Census Tract 14.01, Marion County, Oregon",729,441,288,41,047,001401,3
"Block Group 1, Census Tract 41.02, Multnomah County, Oregon",564,451,113,41,051,004102,1
"Block Group 2, Census Tract 85, Multnomah County, Oregon",492,413,79,41,051,008500,2
"Block Group 3, Census Tract 62, Multnomah County, Oregon",452,322,130,41,051,006200,3
"Block Group 1, Census Tract 9502, Hood River County, Oregon",628,401,227,41,027,950200,1
"Block Group 1, Census Tract 12, Deschutes County, Oregon",528,457,71,41,017,001200,1
"Block Group 4, Census Tract 17, Deschutes County, Oregon",743,623,120,41,017,001700,4
"Block Group 4, Census Tract 1, Benton County, Oregon",1304,836,468,41,003,000100,4
"Block Group 4, Census Tract 9.03, Lane County, Oregon",540,525,15,41,039,000903,4
"Block Group 1, Census Tract 308.01, Washington County, Oregon",895,611,284,41,067,030801,1
"Block Group 1, Census Tract 3, Lane County, Oregon",481,354,127,41,039,000300,1
"Block Group 1, Census Tract 30, Lane County, Oregon",403,298,105,41,039,003000,1
"Block Group 3, Census Tract 18.01, Multnomah County, Oregon",852,255,597,41,051,001801,3
"Block Group 2, Census Tract 329.02, Washington County, Oregon",844,768,76,41,067,032902,2
"Block Group 2, Census Tract 6.01, Multnomah County, Oregon",389,228,161,41,051,000601,2
"Block Group 1, Census Tract 5.04, Coos County, Oregon",374,167,207,41,011,000504,1
"Block Group 1, Census Tract 227.10, Clackamas County, Oregon",1202,387,815,41,005,022710,1
"Block Group 1, Census Tract 318.15, Washington County, Oregon",998,890,108,41,067,031815,1
"Block Group 4, Census Tract 13.02, Jackson County, Oregon",831,539,292,41,029,001302,4
"Block Group 2, Census Tract 13.02, Jackson County, Oregon",912,903,9,41,029,001302,2
"Block Group 1, Census Tract 22, Jackson County, Oregon",449,361,88,41,029,002200,1
"Block Group 2, Census Tract 30.01, Jackson County, Oregon",490,444,46,41,029,003001,2
"Block Group 3, Census Tract 30.01, Jackson County, Oregon",463,378,85,41,029,003001,3
"Block Group 2, Census Tract 6.01, Jackson County, Oregon",564,534,30,41,029,000601,2
"Block Group 1, Census Tract 240, Clackamas County, Oregon",698,667,31,41,005,024000,1
"Block Group 1, Census Tract 218.02, Clackamas County, Oregon",953,353,600,41,005,021802,1
"Block Group 3, Census Tract 9513, Umatilla County, Oregon",376,199,177,41,059,951300,3
"Block Group 3, Census Tract 9501, Umatilla County, Oregon",303,242,61,41,059,950100,3
"Block Group 4, Census Tract 9501, Umatilla County, Oregon",387,285,102,41,059,950100,4
"Block Group 1, Census Tract 9511, Umatilla County, Oregon",237,198,39,41,059,951100,1
"Block Group 2, Census Tract 9511, Umatilla County, Oregon",714,480,234,41,059,951100,2
"Block Group 4, Census Tract 9512, Umatilla County, Oregon",284,184,100,41,059,951200,4
"Block Group 1, Census Tract 9512, Umatilla County, Oregon",1003,655,348,41,059,951200,1
"Block Group 3, Census Tract 9518, Lincoln County, Oregon",452,359,93,41,041,951800,3
"Block Group 3, Census Tract 107.02, Marion County, Oregon",1094,738,356,41,047,010702,3
"Block Group 3, Census Tract 108.01, Marion County, Oregon",524,430,94,41,047,010801,3
"Block Group 4, Census Tract 216.01, Clackamas County, Oregon",335,234,101,41,005,021601,4
"Block Group 3, Census Tract 236, Clackamas County, Oregon",455,372,83,41,005,023600,3
"Block Group 2, Census Tract 236, Clackamas County, Oregon",501,425,76,41,005,023600,2
"Block Group 1, Census Tract 243.02, Clackamas County, Oregon",573,500,73,41,005,024302,1
"Block Group 2, Census Tract 212, Clackamas County, Oregon",277,148,129,41,005,021200,2
"Block Group 3, Census Tract 224, Clackamas County, Oregon",255,176,79,41,005,022400,3
"Block Group 1, Census Tract 9717, Klamath County, Oregon",493,157,336,41,035,971700,1
"Block Group 4, Census Tract 9717, Klamath County, Oregon",230,86,144,41,035,971700,4
"Block Group 2, Census Tract 9710, Klamath County, Oregon",650,594,56,41,035,971000,2
"Block Group 1, Census Tract 9601, Wallowa County, Oregon",918,670,248,41,063,960100,1
"Block Group 1, Census Tract 327, Washington County, Oregon",465,405,60,41,067,032700,1
"Block Group 1, Census Tract 318.04, Washington County, Oregon",819,622,197,41,067,031804,1
"Block Group 2, Census Tract 61, Multnomah County, Oregon",519,325,194,41,051,006100,2
"Block Group 2, Census Tract 62, Multnomah County, Oregon",352,312,40,41,051,006200,2
"Block Group 2, Census Tract 66.01, Multnomah County, Oregon",426,410,16,41,051,006601,2
"Block Group 1, Census Tract 104.05, Multnomah County, Oregon",697,509,188,41,051,010405,1
"Block Group 1, Census Tract 9601, Gilliam County, Oregon",354,203,151,41,021,960100,1
"Block Group 2, Census Tract 9501, Hood River County, Oregon",316,209,107,41,027,950100,2
"Block Group 4, Census Tract 9501, Hood River County, Oregon",316,235,81,41,027,950100,4
"Block Group 4, Census Tract 9502, Hood River County, Oregon",813,620,193,41,027,950200,4
"Block Group 2, Census Tract 9502, Hood River County, Oregon",393,287,106,41,027,950200,2
"Block Group 6, Census Tract 9503, Hood River County, Oregon",659,325,334,41,027,950300,6
"Block Group 4, Census Tract 9503, Hood River County, Oregon",338,241,97,41,027,950300,4
"Block Group 4, Census Tract 9504, Hood River County, Oregon",130,104,26,41,027,950400,4
"Block Group 2, Census Tract 10.01, Benton County, Oregon",668,26,642,41,003,001001,2
"Block Group 2, Census Tract 205.01, Clackamas County, Oregon",1310,800,510,41,005,020501,2
"Block Group 3, Census Tract 205.04, Clackamas County, Oregon",1139,879,260,41,005,020504,3
"Block Group 3, Census Tract 212, Clackamas County, Oregon",734,325,409,41,005,021200,3
"Block Group 3, Census Tract 12, Deschutes County, Oregon",933,876,57,41,017,001200,3
"Block Group 2, Census Tract 98.04, Multnomah County, Oregon",407,284,123,41,051,009804,2
"Block Group 2, Census Tract 95.02, Multnomah County, Oregon",364,278,86,41,051,009502,2
"Block Group 1, Census Tract 104.07, Multnomah County, Oregon",862,752,110,41,051,010407,1
"Block Group 1, Census Tract 20, Multnomah County, Oregon",698,43,655,41,051,002000,1
"Block Group 1, Census Tract 317.03, Washington County, Oregon",566,418,148,41,067,031703,1
"Block Group 1, Census Tract 320.01, Washington County, Oregon",1389,613,776,41,067,032001,1
"Block Group 5, Census Tract 20, Multnomah County, Oregon",738,213,525,41,051,002000,5
"Block Group 2, Census Tract 31, Multnomah County, Oregon",538,335,203,41,051,003100,2
"Block Group 2, Census Tract 46.02, Multnomah County, Oregon",404,398,6,41,051,004602,2
"Block Group 2, Census Tract 69, Multnomah County, Oregon",498,484,14,41,051,006900,2
"Block Group 1, Census Tract 30, Multnomah County, Oregon",486,397,89,41,051,003000,1
"Block Group 1, Census Tract 83.01, Multnomah County, Oregon",727,241,486,41,051,008301,1
"Block Group 1, Census Tract 335, Washington County, Oregon",326,293,33,41,067,033500,1
"Block Group 1, Census Tract 304.01, Washington County, Oregon",450,0,450,41,067,030401,1
"Block Group 3, Census Tract 305.02, Washington County, Oregon",506,250,256,41,067,030502,3
"Block Group 4, Census Tract 305.01, Washington County, Oregon",381,316,65,41,067,030501,4
"Block Group 1, Census Tract 307, Washington County, Oregon",320,62,258,41,067,030700,1
"Block Group 3, Census Tract 315.04, Washington County, Oregon",602,32,570,41,067,031504,3
"Block Group 1, Census Tract 316.12, Washington County, Oregon",1519,720,799,41,067,031612,1
"Block Group 1, Census Tract 316.09, Washington County, Oregon",1203,730,473,41,067,031609,1
"Block Group 1, Census Tract 317.05, Washington County, Oregon",502,223,279,41,067,031705,1
"Block Group 2, Census Tract 10.02, Lane County, Oregon",548,211,337,41,039,001002,2
"Block Group 1, Census Tract 18.04, Lane County, Oregon",341,262,79,41,039,001804,1
"Block Group 3, Census Tract 19.02, Lane County, Oregon",902,532,370,41,039,001902,3
"Block Group 4, Census Tract 19.02, Lane County, Oregon",341,168,173,41,039,001902,4
"Block Group 2, Census Tract 4.04, Lane County, Oregon",384,278,106,41,039,000404,2
"Block Group 2, Census Tract 7.02, Lane County, Oregon",536,464,72,41,039,000702,2
"Block Group 4, Census Tract 9.02, Lane County, Oregon",436,320,116,41,039,000902,4
"Block Group 2, Census Tract 9.02, Lane County, Oregon",507,466,41,41,039,000902,2
"Block Group 2, Census Tract 9703, Malheur County, Oregon",321,212,109,41,045,970300,2
"Block Group 3, Census Tract 9704, Malheur County, Oregon",258,112,146,41,045,970400,3
"Block Group 2, Census Tract 9704, Malheur County, Oregon",421,132,289,41,045,970400,2
"Block Group 1, Census Tract 3610, Josephine County, Oregon",373,302,71,41,033,361000,1
"Block Group 3, Census Tract 3616, Josephine County, Oregon",446,436,10,41,033,361600,3
"Block Group 6, Census Tract 3616, Josephine County, Oregon",479,376,103,41,033,361600,6
"Block Group 1, Census Tract 3608, Josephine County, Oregon",675,401,274,41,033,360800,1
"Block Group 3, Census Tract 3605, Josephine County, Oregon",1134,348,786,41,033,360500,3
"Block Group 2, Census Tract 9504, Lincoln County, Oregon",895,385,510,41,041,950400,2
"Block Group 1, Census Tract 203.02, Polk County, Oregon",399,357,42,41,053,020302,1
"Block Group 5, Census Tract 203.02, Polk County, Oregon",1237,786,451,41,053,020302,5
"Block Group 3, Census Tract 304, Yamhill County, Oregon",476,391,85,41,071,030400,3
"Block Group 4, Census Tract 304, Yamhill County, Oregon",506,368,138,41,071,030400,4
"Block Group 1, Census Tract 307.01, Yamhill County, Oregon",1024,703,321,41,071,030701,1
"Block Group 2, Census Tract 305.02, Yamhill County, Oregon",571,379,192,41,071,030502,2
"Block Group 4, Census Tract 305.02, Yamhill County, Oregon",364,188,176,41,071,030502,4
"Block Group 1, Census Tract 309, Yamhill County, Oregon",828,696,132,41,071,030900,1
"Block Group 4, Census Tract 107.01, Marion County, Oregon",972,440,532,41,047,010701,4
"Block Group 2, Census Tract 15.03, Marion County, Oregon",706,170,536,41,047,001503,2
"Block Group 4, Census Tract 16.01, Marion County, Oregon",386,311,75,41,047,001601,4
"Block Group 3, Census Tract 16.01, Marion County, Oregon",787,293,494,41,047,001601,3
"Block Group 2, Census Tract 16.03, Marion County, Oregon",642,511,131,41,047,001603,2
"Block Group 4, Census Tract 16.03, Marion County, Oregon",681,424,257,41,047,001603,4
"Block Group 3, Census Tract 9706, Union County, Oregon",338,151,187,41,061,970600,3
"Block Group 2, Census Tract 307, Linn County, Oregon",380,354,26,41,043,030700,2
"Block Group 1, Census Tract 306, Linn County, Oregon",336,229,107,41,043,030600,1
"Block Group 2, Census Tract 59, Multnomah County, Oregon",505,307,198,41,051,005900,2
"Block Group 3, Census Tract 59, Multnomah County, Oregon",611,292,319,41,051,005900,3
"Block Group 1, Census Tract 3605, Josephine County, Oregon",286,113,173,41,033,360500,1
"Block Group 3, Census Tract 9702, Klamath County, Oregon",850,686,164,41,035,970200,3
"Block Group 2, Census Tract 9708, Klamath County, Oregon",374,291,83,41,035,970800,2
"Block Group 2, Census Tract 105.02, Marion County, Oregon",1010,764,246,41,047,010502,2
"Block Group 2, Census Tract 17.02, Marion County, Oregon",621,465,156,41,047,001702,2
"Block Group 1, Census Tract 11, Marion County, Oregon",384,277,107,41,047,001100,1
"Block Group 2, Census Tract 6, Marion County, Oregon",682,422,260,41,047,000600,2
"Block Group 2, Census Tract 17.01, Marion County, Oregon",981,262,719,41,047,001701,2
"Block Group 1, Census Tract 17.03, Marion County, Oregon",385,342,43,41,047,001703,1
"Block Group 2, Census Tract 24, Marion County, Oregon",935,735,200,41,047,002400,2
"Block Group 1, Census Tract 103.04, Marion County, Oregon",397,181,216,41,047,010304,1
"Block Group 1, Census Tract 104, Marion County, Oregon",160,120,40,41,047,010400,1
"Block Group 2, Census Tract 9512, Clatsop County, Oregon",480,411,69,41,007,951200,2
"Block Group 2, Census Tract 9513, Clatsop County, Oregon",410,329,81,41,007,951300,2
"Block Group 3, Census Tract 9505, Clatsop County, Oregon",956,617,339,41,007,950500,3
"Block Group 4, Census Tract 9502, Clatsop County, Oregon",265,63,202,41,007,950200,4
"Block Group 2, Census Tract 9503, Clatsop County, Oregon",51,18,33,41,007,950300,2
"Block Group 3, Census Tract 9503, Clatsop County, Oregon",585,176,409,41,007,950300,3
"Block Group 2, Census Tract 9506, Clatsop County, Oregon",403,338,65,41,007,950600,2
"Block Group 6, Census Tract 9509, Clatsop County, Oregon",339,65,274,41,007,950900,6
"Block Group 5, Census Tract 9509, Clatsop County, Oregon",309,90,219,41,007,950900,5
"Block Group 1, Census Tract 28.01, Multnomah County, Oregon",643,572,71,41,051,002801,1
"Block Group 4, Census Tract 5.02, Multnomah County, Oregon",445,224,221,41,051,000502,4
"Block Group 3, Census Tract 5.02, Multnomah County, Oregon",322,216,106,41,051,000502,3
"Block Group 1, Census Tract 8.02, Multnomah County, Oregon",412,245,167,41,051,000802,1
"Block Group 1, Census Tract 10, Multnomah County, Oregon",377,148,229,41,051,001000,1
"Block Group 5, Census Tract 10, Multnomah County, Oregon",580,279,301,41,051,001000,5
"Block Group 1, Census Tract 12.01, Multnomah County, Oregon",444,38,406,41,051,001201,1
"Block Group 3, Census Tract 12.02, Multnomah County, Oregon",395,247,148,41,051,001202,3
"Block Group 4, Census Tract 13.01, Jackson County, Oregon",727,622,105,41,029,001301,4
"Block Group 1, Census Tract 21, Jackson County, Oregon",867,456,411,41,029,002100,1
"Block Group 4, Census Tract 29, Jackson County, Oregon",483,215,268,41,029,002900,4
"Block Group 3, Census Tract 29, Jackson County, Oregon",651,426,225,41,029,002900,3
"Block Group 4, Census Tract 18, Jackson County, Oregon",1004,280,724,41,029,001800,4
"Block Group 1, Census Tract 20, Jackson County, Oregon",634,210,424,41,029,002000,1
"Block Group 1, Census Tract 26, Jackson County, Oregon",566,394,172,41,029,002600,1
"Block Group 2, Census Tract 28, Jackson County, Oregon",960,804,156,41,029,002800,2
"Block Group 2, Census Tract 8, Jackson County, Oregon",954,723,231,41,029,000800,2
"Block Group 3, Census Tract 7, Jackson County, Oregon",225,161,64,41,029,000700,3
"Block Group 3, Census Tract 500.01, Douglas County, Oregon",545,329,216,41,019,050001,3
"Block Group 2, Census Tract 1800, Douglas County, Oregon",240,214,26,41,019,180000,2
"Block Group 3, Census Tract 1800, Douglas County, Oregon",278,199,79,41,019,180000,3
"Block Group 5, Census Tract 9714, Klamath County, Oregon",583,546,37,41,035,971400,5
"Block Group 4, Census Tract 9714, Klamath County, Oregon",492,439,53,41,035,971400,4
"Block Group 3, Census Tract 9715, Klamath County, Oregon",252,191,61,41,035,971500,3
"Block Group 2, Census Tract 9718, Klamath County, Oregon",306,98,208,41,035,971800,2
"Block Group 1, Census Tract 102, Benton County, Oregon",761,596,165,41,003,010200,1
"Block Group 4, Census Tract 11.01, Benton County, Oregon",224,34,190,41,003,001101,4
"Block Group 5, Census Tract 317.04, Washington County, Oregon",312,277,35,41,067,031704,5
"Block Group 3, Census Tract 317.04, Washington County, Oregon",337,305,32,41,067,031704,3
"Block Group 3, Census Tract 11.01, Benton County, Oregon",221,10,211,41,003,001101,3
"Block Group 2, Census Tract 9702, Columbia County, Oregon",497,367,130,41,009,970200,2
"Block Group 1, Census Tract 9708, Columbia County, Oregon",708,312,396,41,009,970800,1
"Block Group 5, Census Tract 9703, Columbia County, Oregon",364,203,161,41,009,970300,5
"Block Group 1, Census Tract 9703, Columbia County, Oregon",427,312,115,41,009,970300,1
"Block Group 1, Census Tract 21.02, Lane County, Oregon",1029,412,617,41,039,002102,1
"Block Group 1, Census Tract 9603, Tillamook County, Oregon",388,240,148,41,057,960300,1
"Block Group 3, Census Tract 91.02, Multnomah County, Oregon",365,47,318,41,051,009102,3
"Block Group 3, Census Tract 31.01, Lane County, Oregon",1150,592,558,41,039,003101,3
"Block Group 4, Census Tract 221.01, Clackamas County, Oregon",527,362,165,41,005,022101,4
"Block Group 4, Census Tract 227.02, Clackamas County, Oregon",298,264,34,41,005,022702,4
"Block Group 3, Census Tract 98.03, Multnomah County, Oregon",556,442,114,41,051,009803,3
"Block Group 3, Census Tract 20, Deschutes County, Oregon",1407,979,428,41,017,002000,3
"Block Group 1, Census Tract 21, Deschutes County, Oregon",921,613,308,41,017,002100,1
"Block Group 3, Census Tract 16, Deschutes County, Oregon",1439,584,855,41,017,001600,3
"Block Group 3, Census Tract 11, Deschutes County, Oregon",2642,1886,756,41,017,001100,3
"Block Group 1, Census Tract 7, Deschutes County, Oregon",698,640,58,41,017,000700,1
"Block Group 1, Census Tract 333.01, Washington County, Oregon",1321,1174,147,41,067,033301,1
"Block Group 2, Census Tract 241, Clackamas County, Oregon",629,602,27,41,005,024100,2
"Block Group 2, Census Tract 206, Clackamas County, Oregon",1168,994,174,41,005,020600,2
"Block Group 2, Census Tract 203.03, Clackamas County, Oregon",564,328,236,41,005,020303,2
"Block Group 1, Census Tract 208, Clackamas County, Oregon",794,204,590,41,005,020800,1
"Block Group 1, Census Tract 9708, Klamath County, Oregon",569,480,89,41,035,970800,1
"Block Group 1, Census Tract 9716, Klamath County, Oregon",203,105,98,41,035,971600,1
"Block Group 1, Census Tract 9712, Klamath County, Oregon",462,246,216,41,035,971200,1
"Block Group 2, Census Tract 9713, Klamath County, Oregon",270,95,175,41,035,971300,2
"Block Group 4, Census Tract 9713, Klamath County, Oregon",238,192,46,41,035,971300,4
"Block Group 3, Census Tract 13, Deschutes County, Oregon",654,352,302,41,017,001300,3
"Block Group 2, Census Tract 14, Deschutes County, Oregon",315,186,129,41,017,001400,2
"Block Group 4, Census Tract 15, Deschutes County, Oregon",375,102,273,41,017,001500,4
"Block Group 2, Census Tract 15, Deschutes County, Oregon",621,245,376,41,017,001500,2
"Block Group 2, Census Tract 17, Deschutes County, Oregon",1042,543,499,41,017,001700,2
"Block Group 4, Census Tract 20, Deschutes County, Oregon",772,556,216,41,017,002000,4
"Block Group 2, Census Tract 9702, Union County, Oregon",548,433,115,41,061,970200,2
"Block Group 3, Census Tract 9705, Union County, Oregon",481,353,128,41,061,970500,3
"Block Group 3, Census Tract 9701, Union County, Oregon",220,172,48,41,061,970100,3
"Block Group 3, Census Tract 9704, Union County, Oregon",322,174,148,41,061,970400,3
"Block Group 2, Census Tract 9703, Columbia County, Oregon",310,251,59,41,009,970300,2
"Block Group 2, Census Tract 9707, Columbia County, Oregon",246,153,93,41,009,970700,2
"Block Group 2, Census Tract 56, Multnomah County, Oregon",429,16,413,41,051,005600,2
"Block Group 3, Census Tract 324.04, Washington County, Oregon",396,351,45,41,067,032404,3
"Block Group 1, Census Tract 314.04, Washington County, Oregon",660,287,373,41,067,031404,1
"Block Group 1, Census Tract 34.02, Multnomah County, Oregon",675,172,503,41,051,003402,1
"Block Group 3, Census Tract 35.01, Multnomah County, Oregon",380,278,102,41,051,003501,3
"Block Group 5, Census Tract 1, Lane County, Oregon",344,232,112,41,039,000100,5
"Block Group 2, Census Tract 1, Lane County, Oregon",532,522,10,41,039,000100,2
"Block Group 1, Census Tract 5, Lane County, Oregon",363,241,122,41,039,000500,1
"Block Group 1, Census Tract 8, Lane County, Oregon",242,149,93,41,039,000800,1
"Block Group 2, Census Tract 19.03, Lane County, Oregon",316,175,141,41,039,001903,2
"Block Group 1, Census Tract 40, Lane County, Oregon",692,20,672,41,039,004000,1
"Block Group 3, Census Tract 44.01, Lane County, Oregon",233,195,38,41,039,004401,3
"Block Group 2, Census Tract 44.01, Lane County, Oregon",766,285,481,41,039,004401,2
"Block Group 2, Census Tract 7, Coos County, Oregon",267,99,168,41,011,000700,2
"Block Group 5, Census Tract 7, Coos County, Oregon",297,174,123,41,011,000700,5
"Block Group 2, Census Tract 10, Coos County, Oregon",673,446,227,41,011,001000,2
"Block Group 5, Census Tract 10, Coos County, Oregon",411,294,117,41,011,001000,5
"Block Group 4, Census Tract 10, Coos County, Oregon",592,371,221,41,011,001000,4
"Block Group 2, Census Tract 315.09, Washington County, Oregon",237,227,10,41,067,031509,2
"Block Group 3, Census Tract 10.01, Jackson County, Oregon",1139,827,312,41,029,001001,3
"Block Group 4, Census Tract 7, Jackson County, Oregon",592,458,134,41,029,000700,4
"Block Group 3, Census Tract 239.02, Clackamas County, Oregon",436,243,193,41,005,023902,3
"Block Group 2, Census Tract 319.04, Washington County, Oregon",657,511,146,41,067,031904,2
"Block Group 3, Census Tract 315.12, Washington County, Oregon",1318,836,482,41,067,031512,3
"Block Group 4, Census Tract 9702, Morrow County, Oregon",159,108,51,41,049,970200,4
"Block Group 3, Census Tract 9702, Morrow County, Oregon",324,120,204,41,049,970200,3
"Block Group 3, Census Tract 313, Washington County, Oregon",615,194,421,41,067,031300,3
"Block Group 3, Census Tract 103.06, Multnomah County, Oregon",424,180,244,41,051,010306,3
"Block Group 2, Census Tract 205.05, Clackamas County, Oregon",439,404,35,41,005,020505,2
"Block Group 2, Census Tract 204.03, Clackamas County, Oregon",412,406,6,41,005,020403,2
"Block Group 3, Census Tract 221.05, Clackamas County, Oregon",890,666,224,41,005,022105,3
"Block Group 2, Census Tract 221.08, Clackamas County, Oregon",921,213,708,41,005,022108,2
"Block Group 2, Census Tract 222.06, Clackamas County, Oregon",1829,1316,513,41,005,022206,2
"Block Group 2, Census Tract 222.08, Clackamas County, Oregon",825,782,43,41,005,022208,2
"Block Group 4, Census Tract 319.07, Washington County, Oregon",357,357,0,41,067,031907,4
"Block Group 1, Census Tract 318.13, Washington County, Oregon",1156,889,267,41,067,031813,1
"Block Group 2, Census Tract 23.02, Lane County, Oregon",541,456,85,41,039,002302,2
"Block Group 2, Census Tract 7.08, Lane County, Oregon",442,345,97,41,039,000708,2
"Block Group 1, Census Tract 7.07, Lane County, Oregon",765,613,152,41,039,000707,1
"Block Group 2, Census Tract 25.04, Lane County, Oregon",887,391,496,41,039,002504,2
"Block Group 1, Census Tract 44.05, Lane County, Oregon",599,535,64,41,039,004405,1
"Block Group 3, Census Tract 9602, Tillamook County, Oregon",348,239,109,41,057,960200,3
"Block Group 1, Census Tract 95.01, Multnomah County, Oregon",1106,719,387,41,051,009501,1
"Block Group 1, Census Tract 94, Multnomah County, Oregon",827,771,56,41,051,009400,1
"Block Group 1, Census Tract 9703, Union County, Oregon",276,214,62,41,061,970300,1
"Block Group 2, Census Tract 9707, Union County, Oregon",307,161,146,41,061,970700,2
"Block Group 1, Census Tract 324.06, Washington County, Oregon",277,107,170,41,067,032406,1
"Block Group 3, Census Tract 19, Multnomah County, Oregon",411,354,57,41,051,001900,3
"Block Group 2, Census Tract 19, Multnomah County, Oregon",468,445,23,41,051,001900,2
"Block Group 3, Census Tract 25.01, Multnomah County, Oregon",324,301,23,41,051,002501,3
"Block Group 2, Census Tract 25.01, Multnomah County, Oregon",338,308,30,41,051,002501,2
"Block Group 1, Census Tract 26, Multnomah County, Oregon",364,347,17,41,051,002600,1
"Block Group 5, Census Tract 29.02, Multnomah County, Oregon",576,543,33,41,051,002902,5
"Block Group 3, Census Tract 29.02, Multnomah County, Oregon",462,372,90,41,051,002902,3
"Block Group 3, Census Tract 203.03, Clackamas County, Oregon",1148,887,261,41,005,020303,3
"Block Group 3, Census Tract 9709, Malheur County, Oregon",284,187,97,41,045,970900,3
"Block Group 3, Census Tract 229.05, Clackamas County, Oregon",543,376,167,41,005,022905,3
"Block Group 2, Census Tract 230.02, Clackamas County, Oregon",896,819,77,41,005,023002,2
"Block Group 2, Census Tract 9601, Wheeler County, Oregon",380,285,95,41,069,960100,2
"Block Group 3, Census Tract 312, Washington County, Oregon",1385,537,848,41,067,031200,3
"Block Group 1, Census Tract 9400, Malheur County, Oregon",0,0,0,41,045,940000,1
"Block Group 2, Census Tract 9709, Malheur County, Oregon",254,162,92,41,045,970900,2
"Block Group 2, Census Tract 208.02, Linn County, Oregon",642,265,377,41,043,020802,2
"Block Group 2, Census Tract 208.01, Linn County, Oregon",733,210,523,41,043,020801,2
"Block Group 1, Census Tract 239.01, Clackamas County, Oregon",1890,1392,498,41,005,023901,1
"Block Group 3, Census Tract 11, Marion County, Oregon",700,234,466,41,047,001100,3
"Block Group 4, Census Tract 20, Marion County, Oregon",1226,651,575,41,047,002000,4
"Block Group 3, Census Tract 203.04, Clackamas County, Oregon",938,348,590,41,005,020304,3
"Block Group 3, Census Tract 22.02, Marion County, Oregon",1179,717,462,41,047,002202,3
"Block Group 1, Census Tract 21.01, Marion County, Oregon",683,123,560,41,047,002101,1
"Block Group 1, Census Tract 25.01, Marion County, Oregon",1382,1088,294,41,047,002501,1
"Block Group 3, Census Tract 23.04, Marion County, Oregon",1034,324,710,41,047,002304,3
"Block Group 2, Census Tract 102.02, Marion County, Oregon",784,635,149,41,047,010202,2
"Block Group 4, Census Tract 102.02, Marion County, Oregon",999,752,247,41,047,010202,4
"Block Group 3, Census Tract 103.07, Marion County, Oregon",716,626,90,41,047,010307,3
"Block Group 1, Census Tract 22.01, Marion County, Oregon",584,468,116,41,047,002201,1
"Block Group 3, Census Tract 315.08, Washington County, Oregon",485,129,356,41,067,031508,3
"Block Group 1, Census Tract 315.11, Washington County, Oregon",851,688,163,41,067,031511,1
"Block Group 2, Census Tract 318.06, Washington County, Oregon",614,511,103,41,067,031806,2
"Block Group 1, Census Tract 322, Washington County, Oregon",1670,1469,201,41,067,032200,1
"Block Group 1, Census Tract 332, Washington County, Oregon",300,162,138,41,067,033200,1
"Block Group 2, Census Tract 210, Clackamas County, Oregon",1023,681,342,41,005,021000,2
"Block Group 1, Census Tract 215, Clackamas County, Oregon",842,727,115,41,005,021500,1
"Block Group 1, Census Tract 226.02, Clackamas County, Oregon",852,772,80,41,005,022602,1
"Block Group 3, Census Tract 227.02, Clackamas County, Oregon",446,416,30,41,005,022702,3
"Block Group 2, Census Tract 9510, Lincoln County, Oregon",560,168,392,41,041,951000,2
"Block Group 1, Census Tract 9706, Klamath County, Oregon",593,404,189,41,035,970600,1
"Block Group 3, Census Tract 9709, Klamath County, Oregon",490,212,278,41,035,970900,3
"Block Group 2, Census Tract 9719, Klamath County, Oregon",329,103,226,41,035,971900,2
"Block Group 2, Census Tract 9720, Klamath County, Oregon",453,233,220,41,035,972000,2
"Block Group 3, Census Tract 9720, Klamath County, Oregon",629,387,242,41,035,972000,3
"Block Group 3, Census Tract 2, Marion County, Oregon",580,231,349,41,047,000200,3
"Block Group 1, Census Tract 3, Marion County, Oregon",522,242,280,41,047,000300,1
"Block Group 1, Census Tract 12, Marion County, Oregon",805,435,370,41,047,001200,1
"Block Group 2, Census Tract 25.02, Multnomah County, Oregon",539,114,425,41,051,002502,2
"Block Group 1, Census Tract 25.02, Multnomah County, Oregon",248,175,73,41,051,002502,1
"Block Group 2, Census Tract 27.01, Multnomah County, Oregon",494,466,28,41,051,002701,2
"Block Group 4, Census Tract 37.01, Multnomah County, Oregon",307,230,77,41,051,003701,4
"Block Group 1, Census Tract 39.02, Multnomah County, Oregon",256,174,82,41,051,003902,1
"Block Group 1, Census Tract 48, Multnomah County, Oregon",730,167,563,41,051,004800,1
"Block Group 1, Census Tract 49, Multnomah County, Oregon",1449,329,1120,41,051,004900,1
"Block Group 1, Census Tract 67.02, Multnomah County, Oregon",914,443,471,41,051,006702,1
"Block Group 1, Census Tract 105, Multnomah County, Oregon",346,321,25,41,051,010500,1
"Block Group 3, Census Tract 82.01, Multnomah County, Oregon",314,189,125,41,051,008201,3
"Block Group 3, Census Tract 38.03, Multnomah County, Oregon",558,315,243,41,051,003803,3
"Block Group 2, Census Tract 63, Multnomah County, Oregon",444,422,22,41,051,006300,2
"Block Group 3, Census Tract 32, Multnomah County, Oregon",322,266,56,41,051,003200,3
"Block Group 1, Census Tract 32, Multnomah County, Oregon",480,181,299,41,051,003200,1
"Block Group 2, Census Tract 33.02, Multnomah County, Oregon",921,390,531,41,051,003302,2
"Block Group 3, Census Tract 34.01, Multnomah County, Oregon",278,234,44,41,051,003401,3
"Block Group 1, Census Tract 3.02, Multnomah County, Oregon",483,470,13,41,051,000302,1
"Block Group 3, Census Tract 320.05, Washington County, Oregon",929,235,694,41,067,032005,3
"Block Group 2, Census Tract 308.05, Washington County, Oregon",365,239,126,41,067,030805,2
"Block Group 2, Census Tract 319.07, Washington County, Oregon",402,362,40,41,067,031907,2
"Block Group 1, Census Tract 9, Deschutes County, Oregon",985,299,686,41,017,000900,1
"Block Group 1, Census Tract 18, Deschutes County, Oregon",969,378,591,41,017,001800,1
"Block Group 4, Census Tract 18, Deschutes County, Oregon",795,185,610,41,017,001800,4
"Block Group 3, Census Tract 2, Deschutes County, Oregon",631,237,394,41,017,000200,3
"Block Group 4, Census Tract 2, Deschutes County, Oregon",350,248,102,41,017,000200,4
"Block Group 4, Census Tract 3, Deschutes County, Oregon",763,719,44,41,017,000300,4
"Block Group 5, Census Tract 5, Deschutes County, Oregon",832,791,41,41,017,000500,5
"Block Group 3, Census Tract 9504, Curry County, Oregon",866,577,289,41,015,950400,3
"Block Group 2, Census Tract 9504, Curry County, Oregon",616,456,160,41,015,950400,2
"Block Group 2, Census Tract 96.03, Multnomah County, Oregon",652,332,320,41,051,009603,2
"Block Group 3, Census Tract 9708, Union County, Oregon",457,296,161,41,061,970800,3
"Block Group 2, Census Tract 9708, Union County, Oregon",370,140,230,41,061,970800,2
"Block Group 5, Census Tract 203, Linn County, Oregon",1315,1156,159,41,043,020300,5
"Block Group 3, Census Tract 203, Linn County, Oregon",493,155,338,41,043,020300,3
"Block Group 3, Census Tract 204, Linn County, Oregon",594,213,381,41,043,020400,3
"Block Group 3, Census Tract 305, Linn County, Oregon",557,428,129,41,043,030500,3
"Block Group 4, Census Tract 16.02, Jackson County, Oregon",393,380,13,41,029,001602,4
"Block Group 2, Census Tract 16.02, Jackson County, Oregon",815,422,393,41,029,001602,2
"Block Group 2, Census Tract 16.01, Jackson County, Oregon",622,522,100,41,029,001601,2
"Block Group 1, Census Tract 4.03, Jackson County, Oregon",1324,902,422,41,029,000403,1
"Block Group 2, Census Tract 316.14, Washington County, Oregon",1084,650,434,41,067,031614,2
"Block Group 2, Census Tract 324.07, Washington County, Oregon",1031,721,310,41,067,032407,2
"Block Group 1, Census Tract 321.08, Washington County, Oregon",510,458,52,41,067,032108,1
"Block Group 1, Census Tract 9800, Multnomah County, Oregon",0,0,0,41,051,980000,1
"Block Group 1, Census Tract 9400, Umatilla County, Oregon",356,317,39,41,059,940000,1
"Block Group 1, Census Tract 222.07, Clackamas County, Oregon",1458,1433,25,41,005,022207,1
"Block Group 3, Census Tract 223.01, Clackamas County, Oregon",401,250,151,41,005,022301,3
"Block Group 1, Census Tract 223.02, Clackamas County, Oregon",637,597,40,41,005,022302,1
"Block Group 1, Census Tract 226.06, Clackamas County, Oregon",1872,1687,185,41,005,022606,1
"Block Group 2, Census Tract 226.05, Clackamas County, Oregon",1030,553,477,41,005,022605,2
"Block Group 2, Census Tract 1, Benton County, Oregon",735,178,557,41,003,000100,2
"Block Group 1, Census Tract 6, Benton County, Oregon",921,217,704,41,003,000600,1
"Block Group 2, Census Tract 47, Lane County, Oregon",322,183,139,41,039,004700,2
"Block Group 4, Census Tract 50, Lane County, Oregon",571,502,69,41,039,005000,4
"Block Group 2, Census Tract 50, Lane County, Oregon",701,317,384,41,039,005000,2
"Block Group 3, Census Tract 44.03, Lane County, Oregon",346,68,278,41,039,004403,3
"Block Group 2, Census Tract 48, Lane County, Oregon",472,289,183,41,039,004800,2
"Block Group 2, Census Tract 9.03, Lane County, Oregon",648,548,100,41,039,000903,2
"Block Group 3, Census Tract 13.02, Lane County, Oregon",622,406,216,41,039,001302,3
"Block Group 1, Census Tract 13.02, Lane County, Oregon",581,449,132,41,039,001302,1
"Block Group 5, Census Tract 16, Lane County, Oregon",458,361,97,41,039,001600,5
"Block Group 2, Census Tract 21.01, Lane County, Oregon",639,277,362,41,039,002101,2
"Block Group 1, Census Tract 334, Washington County, Oregon",367,348,19,41,067,033400,1
"Block Group 1, Census Tract 302, Washington County, Oregon",662,430,232,41,067,030200,1
"Block Group 2, Census Tract 308.01, Washington County, Oregon",570,552,18,41,067,030801,2
"Block Group 1, Census Tract 316.11, Washington County, Oregon",1056,509,547,41,067,031611,1
"Block Group 1, Census Tract 17.01, Multnomah County, Oregon",235,153,82,41,051,001701,1
"Block Group 2, Census Tract 9706, Columbia County, Oregon",292,179,113,41,009,970600,2
"Block Group 4, Census Tract 9706, Columbia County, Oregon",671,641,30,41,009,970600,4
"Block Group 3, Census Tract 9709, Columbia County, Oregon",1169,856,313,41,009,970900,3
"Block Group 1, Census Tract 9512, Lincoln County, Oregon",584,478,106,41,041,951200,1
"Block Group 1, Census Tract 101, Marion County, Oregon",272,203,69,41,047,010100,1
"Block Group 1, Census Tract 221.03, Clackamas County, Oregon",1316,887,429,41,005,022103,1
"Block Group 1, Census Tract 229.01, Clackamas County, Oregon",1382,1188,194,41,005,022901,1
"Block Group 4, Census Tract 235, Clackamas County, Oregon",219,219,0,41,005,023500,4
"Block Group 4, Census Tract 238, Clackamas County, Oregon",887,593,294,41,005,023800,4
"Block Group 2, Census Tract 49, Lane County, Oregon",744,243,501,41,039,004900,2
"Block Group 2, Census Tract 3, Lane County, Oregon",452,326,126,41,039,000300,2
"Block Group 2, Census Tract 11.01, Lane County, Oregon",621,286,335,41,039,001101,2
"Block Group 2, Census Tract 11.02, Lane County, Oregon",654,352,302,41,039,001102,2
"Block Group 1, Census Tract 14, Lane County, Oregon",630,568,62,41,039,001400,1
"Block Group 2, Census Tract 17, Lane County, Oregon",321,256,65,41,039,001700,2
"Block Group 2, Census Tract 24.01, Lane County, Oregon",647,590,57,41,039,002401,2
"Block Group 2, Census Tract 500.02, Douglas County, Oregon",407,195,212,41,019,050002,2
"Block Group 1, Census Tract 1000, Douglas County, Oregon",411,255,156,41,019,100000,1
"Block Group 3, Census Tract 1200, Douglas County, Oregon",500,346,154,41,019,120000,3
"Block Group 6, Census Tract 1200, Douglas County, Oregon",287,178,109,41,019,120000,6
"Block Group 4, Census Tract 900, Douglas County, Oregon",638,418,220,41,019,090000,4
"Block Group 3, Census Tract 900, Douglas County, Oregon",1341,1014,327,41,019,090000,3
"Block Group 1, Census Tract 309.02, Linn County, Oregon",378,295,83,41,043,030902,1
"Block Group 4, Census Tract 309.03, Linn County, Oregon",675,468,207,41,043,030903,4
"Block Group 2, Census Tract 309.03, Linn County, Oregon",441,197,244,41,043,030903,2
"Block Group 2, Census Tract 309.04, Linn County, Oregon",744,352,392,41,043,030904,2
"Block Group 2, Census Tract 201, Linn County, Oregon",788,522,266,41,043,020100,2
"Block Group 1, Census Tract 206, Linn County, Oregon",1264,450,814,41,043,020600,1
"Block Group 5, Census Tract 206, Linn County, Oregon",423,323,100,41,043,020600,5
"Block Group 4, Census Tract 304.02, Linn County, Oregon",506,325,181,41,043,030402,4
"Block Group 3, Census Tract 304.02, Linn County, Oregon",495,400,95,41,043,030402,3
"Block Group 3, Census Tract 308, Linn County, Oregon",686,347,339,41,043,030800,3
"Block Group 4, Census Tract 1300, Douglas County, Oregon",678,494,184,41,019,130000,4
"Block Group 3, Census Tract 9, Coos County, Oregon",426,202,224,41,011,000900,3
"Block Group 5, Census Tract 9, Coos County, Oregon",261,167,94,41,011,000900,5
"Block Group 1, Census Tract 9501, Curry County, Oregon",451,404,47,41,015,950100,1
"Block Group 3, Census Tract 310.05, Washington County, Oregon",563,116,447,41,067,031005,3
"Block Group 1, Census Tract 9515, Lincoln County, Oregon",457,339,118,41,041,951500,1
"Block Group 1, Census Tract 9513, Lincoln County, Oregon",487,435,52,41,041,951300,1
"Block Group 3, Census Tract 5, Benton County, Oregon",410,323,87,41,003,000500,3
"Block Group 2, Census Tract 9, Benton County, Oregon",269,160,109,41,003,000900,2
"Block Group 1, Census Tract 9, Benton County, Oregon",325,311,14,41,003,000900,1
"Block Group 2, Census Tract 10.02, Benton County, Oregon",618,243,375,41,003,001002,2
"Block Group 2, Census Tract 25.01, Lane County, Oregon",754,557,197,41,039,002501,2
"Block Group 2, Census Tract 238, Clackamas County, Oregon",382,312,70,41,005,023800,2
"Block Group 1, Census Tract 216.01, Clackamas County, Oregon",374,209,165,41,005,021601,1
"Block Group 2, Census Tract 9701, Klamath County, Oregon",870,713,157,41,035,970100,2
"Block Group 1, Census Tract 30.02, Jackson County, Oregon",571,526,45,41,029,003002,1
"Block Group 3, Census Tract 25, Jackson County, Oregon",208,182,26,41,029,002500,3
"Block Group 3, Census Tract 9, Jackson County, Oregon",291,278,13,41,029,000900,3
"Block Group 2, Census Tract 14, Jackson County, Oregon",902,782,120,41,029,001400,2
"Block Group 1, Census Tract 23, Jackson County, Oregon",262,238,24,41,029,002300,1
"Block Group 2, Census Tract 2.01, Jackson County, Oregon",500,212,288,41,029,000201,2
"Block Group 3, Census Tract 15, Jackson County, Oregon",261,195,66,41,029,001500,3
"Block Group 1, Census Tract 2000, Douglas County, Oregon",454,359,95,41,019,200000,1
"Block Group 3, Census Tract 9602, Grant County, Oregon",698,550,148,41,023,960200,3
"Block Group 1, Census Tract 9602, Grant County, Oregon",353,285,68,41,023,960200,1
"Block Group 1, Census Tract 308, Linn County, Oregon",345,256,89,41,043,030800,1
"Block Group 5, Census Tract 308, Linn County, Oregon",673,309,364,41,043,030800,5
"Block Group 2, Census Tract 301, Linn County, Oregon",517,342,175,41,043,030100,2
"Block Group 1, Census Tract 9608, Tillamook County, Oregon",411,275,136,41,057,960800,1
"Block Group 1, Census Tract 9606, Tillamook County, Oregon",172,118,54,41,057,960600,1
"Block Group 2, Census Tract 9606, Tillamook County, Oregon",429,333,96,41,057,960600,2
"Block Group 1, Census Tract 9601, Tillamook County, Oregon",553,481,72,41,057,960100,1
"Block Group 2, Census Tract 9604, Tillamook County, Oregon",650,274,376,41,057,960400,2
"Block Group 2, Census Tract 13.01, Lane County, Oregon",604,330,274,41,039,001301,2
"Block Group 1, Census Tract 18.03, Lane County, Oregon",519,406,113,41,039,001803,1
"Block Group 2, Census Tract 19.04, Lane County, Oregon",929,287,642,41,039,001904,2
"Block Group 1, Census Tract 20.01, Lane County, Oregon",798,555,243,41,039,002001,1
"Block Group 2, Census Tract 5, Deschutes County, Oregon",169,169,0,41,017,000500,2
"Block Group 3, Census Tract 7.05, Lane County, Oregon",596,206,390,41,039,000705,3
"Block Group 2, Census Tract 25.03, Lane County, Oregon",768,749,19,41,039,002503,2
"Block Group 2, Census Tract 44.04, Lane County, Oregon",410,322,88,41,039,004404,2
"Block Group 1, Census Tract 9603.02, Jefferson County, Oregon",240,200,40,41,031,960302,1
"Block Group 2, Census Tract 9502, Curry County, Oregon",801,522,279,41,015,950200,2
"Block Group 3, Census Tract 9503.01, Curry County, Oregon",607,358,249,41,015,950301,3
"Block Group 2, Census Tract 12.01, Lane County, Oregon",445,388,57,41,039,001201,2
"Block Group 3, Census Tract 31.02, Lane County, Oregon",1269,0,1269,41,039,003102,3
"Block Group 1, Census Tract 27, Lane County, Oregon",874,523,351,41,039,002700,1
"Block Group 1, Census Tract 32.01, Lane County, Oregon",274,97,177,41,039,003201,1
"Block Group 1, Census Tract 12.02, Lane County, Oregon",684,575,109,41,039,001202,1
"Block Group 3, Census Tract 15, Lane County, Oregon",325,224,101,41,039,001500,3
"Block Group 2, Census Tract 18.01, Lane County, Oregon",778,562,216,41,039,001801,2
"Block Group 3, Census Tract 54, Lane County, Oregon",846,768,78,41,039,005400,3
"Block Group 4, Census Tract 54, Lane County, Oregon",383,168,215,41,039,005400,4
"Block Group 3, Census Tract 43, Lane County, Oregon",445,228,217,41,039,004300,3
"Block Group 1, Census Tract 38.01, Multnomah County, Oregon",560,348,212,41,051,003801,1
"Block Group 1, Census Tract 2, Lane County, Oregon",609,486,123,41,039,000200,1
"Block Group 3, Census Tract 2, Lane County, Oregon",307,297,10,41,039,000200,3
"Block Group 2, Census Tract 26, Lane County, Oregon",558,424,134,41,039,002600,2
"Block Group 2, Census Tract 4.03, Lane County, Oregon",590,458,132,41,039,000403,2
"Block Group 2, Census Tract 9.04, Lane County, Oregon",904,712,192,41,039,000904,2
"Block Group 1, Census Tract 20.02, Lane County, Oregon",987,822,165,41,039,002002,1
"Block Group 1, Census Tract 24.03, Lane County, Oregon",797,644,153,41,039,002403,1
"Block Group 1, Census Tract 73, Multnomah County, Oregon",186,78,108,41,051,007300,1
"Block Group 3, Census Tract 89.01, Multnomah County, Oregon",602,585,17,41,051,008901,3
"Block Group 3, Census Tract 90, Multnomah County, Oregon",1247,480,767,41,051,009000,3
"Block Group 1, Census Tract 92.02, Multnomah County, Oregon",796,466,330,41,051,009202,1
"Block Group 4, Census Tract 52.02, Polk County, Oregon",1210,929,281,41,053,005202,4
"Block Group 1, Census Tract 52.02, Polk County, Oregon",701,345,356,41,053,005202,1
"Block Group 1, Census Tract 53, Polk County, Oregon",410,318,92,41,053,005300,1
"Block Group 6, Census Tract 9604, Tillamook County, Oregon",283,199,84,41,057,960400,6
"Block Group 2, Census Tract 9605, Tillamook County, Oregon",346,108,238,41,057,960500,2
"Block Group 1, Census Tract 9607, Tillamook County, Oregon",436,376,60,41,057,960700,1
"Block Group 2, Census Tract 305.01, Yamhill County, Oregon",296,242,54,41,071,030501,2
"Block Group 2, Census Tract 307.02, Yamhill County, Oregon",287,76,211,41,071,030702,2
"Block Group 2, Census Tract 310, Yamhill County, Oregon",751,562,189,41,071,031000,2
"Block Group 1, Census Tract 302.01, Yamhill County, Oregon",517,355,162,41,071,030201,1
"Block Group 1, Census Tract 105.03, Marion County, Oregon",363,152,211,41,047,010503,1
"Block Group 3, Census Tract 107.01, Marion County, Oregon",257,121,136,41,047,010701,3
"Block Group 2, Census Tract 202.02, Polk County, Oregon",964,788,176,41,053,020202,2
"Block Group 2, Census Tract 52.01, Polk County, Oregon",1891,1589,302,41,053,005201,2
"Block Group 2, Census Tract 29.02, Lane County, Oregon",615,396,219,41,039,002902,2
"Block Group 3, Census Tract 30, Lane County, Oregon",581,486,95,41,039,003000,3
"Block Group 2, Census Tract 1600, Douglas County, Oregon",969,520,449,41,019,160000,2
"Block Group 2, Census Tract 1900, Douglas County, Oregon",536,324,212,41,019,190000,2
"Block Group 2, Census Tract 200, Douglas County, Oregon",411,322,89,41,019,020000,2
"Block Group 1, Census Tract 200, Douglas County, Oregon",223,181,42,41,019,020000,1
"Block Group 2, Census Tract 1100, Douglas County, Oregon",444,382,62,41,019,110000,2
"Block Group 3, Census Tract 1500, Douglas County, Oregon",617,519,98,41,019,150000,3
"Block Group 3, Census Tract 302, Linn County, Oregon",239,219,20,41,043,030200,3
"Block Group 1, Census Tract 302, Linn County, Oregon",432,280,152,41,043,030200,1
"Block Group 4, Census Tract 302, Linn County, Oregon",417,337,80,41,043,030200,4
"Block Group 2, Census Tract 303, Linn County, Oregon",340,299,41,41,043,030300,2
"Block Group 3, Census Tract 304.01, Linn County, Oregon",472,357,115,41,043,030401,3
"Block Group 1, Census Tract 17, Jackson County, Oregon",652,308,344,41,029,001700,1
"Block Group 1, Census Tract 19, Jackson County, Oregon",710,120,590,41,029,001900,1
"Block Group 2, Census Tract 1, Jackson County, Oregon",432,23,409,41,029,000100,2
"Block Group 2, Census Tract 224, Clackamas County, Oregon",398,223,175,41,005,022400,2
"Block Group 3, Census Tract 237, Clackamas County, Oregon",472,385,87,41,005,023700,3
"Block Group 5, Census Tract 1800, Douglas County, Oregon",446,370,76,41,019,180000,5
"Block Group 2, Census Tract 800, Douglas County, Oregon",639,513,126,41,019,080000,2
"Block Group 1, Census Tract 209, Clackamas County, Oregon",425,353,72,41,005,020900,1
"Block Group 2, Census Tract 216.02, Clackamas County, Oregon",366,279,87,41,005,021602,2
"Block Group 1, Census Tract 202, Clackamas County, Oregon",579,439,140,41,005,020200,1
"Block Group 2, Census Tract 310.03, Washington County, Oregon",430,250,180,41,067,031003,2
"Block Group 3, Census Tract 310.06, Washington County, Oregon",502,286,216,41,067,031006,3
"Block Group 1, Census Tract 317.06, Washington County, Oregon",1092,99,993,41,067,031706,1
"Block Group 2, Census Tract 316.10, Washington County, Oregon",651,111,540,41,067,031610,2
"Block Group 3, Census Tract 321.04, Washington County, Oregon",547,484,63,41,067,032104,3
"Block Group 1, Census Tract 324.10, Washington County, Oregon",677,491,186,41,067,032410,1
"Block Group 1, Census Tract 37, Lane County, Oregon",759,82,677,41,039,003700,1
"Block Group 1, Census Tract 52, Lane County, Oregon",478,258,220,41,039,005200,1
"Block Group 3, Census Tract 35, Lane County, Oregon",284,263,21,41,039,003500,3
"Block Group 3, Census Tract 36, Lane County, Oregon",628,386,242,41,039,003600,3
"Block Group 2, Census Tract 36.01, Multnomah County, Oregon",694,436,258,41,051,003601,2
"Block Group 1, Census Tract 22.02, Lane County, Oregon",1245,826,419,41,039,002202,1
"Block Group 2, Census Tract 38, Lane County, Oregon",353,9,344,41,039,003800,2
"Block Group 3, Census Tract 5.02, Marion County, Oregon",973,260,713,41,047,000502,3
"Block Group 1, Census Tract 14.01, Marion County, Oregon",1067,894,173,41,047,001401,1
"Block Group 3, Census Tract 25.02, Marion County, Oregon",428,377,51,41,047,002502,3
"Block Group 2, Census Tract 8.01, Multnomah County, Oregon",666,354,312,41,051,000801,2
"Block Group 4, Census Tract 29.01, Multnomah County, Oregon",702,548,154,41,051,002901,4
"Block Group 1, Census Tract 36.03, Multnomah County, Oregon",305,259,46,41,051,003603,1
"Block Group 1, Census Tract 40.02, Multnomah County, Oregon",372,295,77,41,051,004002,1
"Block Group 4, Census Tract 41.02, Multnomah County, Oregon",605,378,227,41,051,004102,4
"Block Group 1, Census Tract 43, Multnomah County, Oregon",443,360,83,41,051,004300,1
"Block Group 1, Census Tract 28.02, Multnomah County, Oregon",374,347,27,41,051,002802,1
"Block Group 3, Census Tract 36.02, Multnomah County, Oregon",635,496,139,41,051,003602,3
"Block Group 4, Census Tract 36.02, Multnomah County, Oregon",574,420,154,41,051,003602,4
"Block Group 1, Census Tract 60.02, Multnomah County, Oregon",954,628,326,41,051,006002,1
"Block Group 2, Census Tract 71, Multnomah County, Oregon",286,209,77,41,051,007100,2
"Block Group 1, Census Tract 80.01, Multnomah County, Oregon",618,424,194,41,051,008001,1
"Block Group 1, Census Tract 306, Washington County, Oregon",1127,754,373,41,067,030600,1
"Block Group 2, Census Tract 40.01, Multnomah County, Oregon",415,335,80,41,051,004001,2
"Block Group 1, Census Tract 40.01, Multnomah County, Oregon",910,273,637,41,051,004001,1
"Block Group 2, Census Tract 52, Multnomah County, Oregon",604,59,545,41,051,005200,2
"Block Group 2, Census Tract 60.01, Multnomah County, Oregon",279,235,44,41,051,006001,2
"Block Group 1, Census Tract 9706, Wasco County, Oregon",505,270,235,41,065,970600,1
"Block Group 1, Census Tract 9703, Wasco County, Oregon",284,251,33,41,065,970300,1
"Block Group 1, Census Tract 7.01, Marion County, Oregon",1017,382,635,41,047,000701,1
"Block Group 3, Census Tract 92.02, Multnomah County, Oregon",488,298,190,41,051,009202,3
"Block Group 1, Census Tract 93.01, Multnomah County, Oregon",784,457,327,41,051,009301,1
"Block Group 1, Census Tract 84, Multnomah County, Oregon",628,264,364,41,051,008400,1
"Block Group 2, Census Tract 89.02, Multnomah County, Oregon",525,123,402,41,051,008902,2
"Block Group 3, Census Tract 104.02, Multnomah County, Oregon",780,615,165,41,051,010402,3
"Block Group 1, Census Tract 104.08, Multnomah County, Oregon",421,260,161,41,051,010408,1
"Block Group 7, Census Tract 9502, Umatilla County, Oregon",276,168,108,41,059,950200,7
"Block Group 1, Census Tract 108.02, Marion County, Oregon",559,439,120,41,047,010802,1
"Block Group 3, Census Tract 108.02, Marion County, Oregon",419,175,244,41,047,010802,3
"Block Group 1, Census Tract 18.01, Marion County, Oregon",687,332,355,41,047,001801,1
"Block Group 2, Census Tract 228, Clackamas County, Oregon",808,754,54,41,005,022800,2
"Block Group 1, Census Tract 232.02, Clackamas County, Oregon",324,213,111,41,005,023202,1
"Block Group 3, Census Tract 232.02, Clackamas County, Oregon",1660,1548,112,41,005,023202,3
"Block Group 1, Census Tract 9503, Baker County, Oregon",400,317,83,41,001,950300,1
"Block Group 2, Census Tract 9501, Baker County, Oregon",283,214,69,41,001,950100,2
"Block Group 2, Census Tract 9504, Baker County, Oregon",310,218,92,41,001,950400,2
"Block Group 3, Census Tract 9506, Baker County, Oregon",457,357,100,41,001,950600,3
"Block Group 2, Census Tract 9506, Baker County, Oregon",274,173,101,41,001,950600,2
"Block Group 1, Census Tract 9502, Baker County, Oregon",405,337,68,41,001,950200,1
"Block Group 2, Census Tract 3611, Josephine County, Oregon",1166,732,434,41,033,361100,2
"Block Group 2, Census Tract 3613, Josephine County, Oregon",812,644,168,41,033,361300,2
"Block Group 3, Census Tract 16.04, Marion County, Oregon",711,583,128,41,047,001604,3
"Block Group 2, Census Tract 13, Marion County, Oregon",775,235,540,41,047,001300,2
"Block Group 2, Census Tract 15.01, Marion County, Oregon",541,512,29,41,047,001501,2
"Block Group 3, Census Tract 16.02, Marion County, Oregon",540,281,259,41,047,001602,3
"Block Group 1, Census Tract 18.02, Marion County, Oregon",509,357,152,41,047,001802,1
"Block Group 4, Census Tract 18.02, Marion County, Oregon",719,312,407,41,047,001802,4
"Block Group 2, Census Tract 23.01, Marion County, Oregon",364,271,93,41,047,002301,2
"Block Group 4, Census Tract 9701, Morrow County, Oregon",615,312,303,41,049,970100,4
"Block Group 1, Census Tract 9602, Lake County, Oregon",246,173,73,41,037,960200,1
"Block Group 7, Census Tract 9602, Lake County, Oregon",312,146,166,41,037,960200,7
"Block Group 6, Census Tract 9602, Lake County, Oregon",280,233,47,41,037,960200,6
"Block Group 3, Census Tract 3.01, Multnomah County, Oregon",678,332,346,41,051,000301,3
"Block Group 3, Census Tract 202.04, Polk County, Oregon",881,816,65,41,053,020204,3
"Block Group 2, Census Tract 51, Polk County, Oregon",500,231,269,41,053,005100,2
"Block Group 4, Census Tract 105.01, Marion County, Oregon",510,410,100,41,047,010501,4
"Block Group 1, Census Tract 9501, Crook County, Oregon",391,303,88,41,013,950100,1
"Block Group 1, Census Tract 9502, Crook County, Oregon",501,455,46,41,013,950200,1
"Block Group 3, Census Tract 9502, Crook County, Oregon",474,192,282,41,013,950200,3
"Block Group 3, Census Tract 9503, Crook County, Oregon",576,260,316,41,013,950300,3
"Block Group 1, Census Tract 9503, Crook County, Oregon",295,83,212,41,013,950300,1
"Block Group 2, Census Tract 9702, Wasco County, Oregon",456,221,235,41,065,970200,2
"Block Group 1, Census Tract 9705, Wasco County, Oregon",401,253,148,41,065,970500,1
"Block Group 1, Census Tract 9707, Wasco County, Oregon",234,165,69,41,065,970700,1
"Block Group 1, Census Tract 9704, Wasco County, Oregon",511,154,357,41,065,970400,1
"Block Group 2, Census Tract 39, Lane County, Oregon",1016,34,982,41,039,003900,2
"Block Group 4, Census Tract 11, Coos County, Oregon",404,313,91,41,011,001100,4
"Block Group 7, Census Tract 11, Coos County, Oregon",530,398,132,41,011,001100,7
"Block Group 3, Census Tract 6, Coos County, Oregon",508,273,235,41,011,000600,3
"Block Group 2, Census Tract 8, Coos County, Oregon",807,571,236,41,011,000800,2
"Block Group 1, Census Tract 64.02, Multnomah County, Oregon",1132,1072,60,41,051,006402,1
"Block Group 1, Census Tract 70, Multnomah County, Oregon",340,308,32,41,051,007000,1
"Block Group 1, Census Tract 72.01, Multnomah County, Oregon",488,431,57,41,051,007201,1
"Block Group 2, Census Tract 106, Benton County, Oregon",404,22,382,41,003,010600,2
"Block Group 4, Census Tract 104.08, Multnomah County, Oregon",534,242,292,41,051,010408,4
"Block Group 2, Census Tract 9602, Harney County, Oregon",336,211,125,41,025,960200,2
"Block Group 1, Census Tract 9601, Harney County, Oregon",616,451,165,41,025,960100,1
"Block Group 4, Census Tract 313, Washington County, Oregon",817,301,516,41,067,031300,4
"Block Group 2, Census Tract 29.03, Lane County, Oregon",686,445,241,41,039,002903,2
"Block Group 1, Census Tract 23.01, Lane County, Oregon",1256,702,554,41,039,002301,1
"Block Group 2, Census Tract 45.01, Lane County, Oregon",449,115,334,41,039,004501,2
"Block Group 2, Census Tract 99.04, Multnomah County, Oregon",466,226,240,41,051,009904,2
"Block Group 4, Census Tract 304.01, Linn County, Oregon",394,136,258,41,043,030401,4
"Block Group 1, Census Tract 307, Linn County, Oregon",277,250,27,41,043,030700,1
"Block Group 2, Census Tract 35.02, Multnomah County, Oregon",538,446,92,41,051,003502,2
"Block Group 3, Census Tract 318.05, Washington County, Oregon",329,287,42,41,067,031805,3
"Block Group 2, Census Tract 318.05, Washington County, Oregon",1002,986,16,41,067,031805,2
"Block Group 2, Census Tract 326.03, Washington County, Oregon",438,421,17,41,067,032603,2
"Block Group 2, Census Tract 325.03, Washington County, Oregon",508,447,61,41,067,032503,2
"Block Group 3, Census Tract 203.04, Polk County, Oregon",1349,920,429,41,053,020304,3
"Block Group 1, Census Tract 203.03, Polk County, Oregon",818,236,582,41,053,020303,1
"Block Group 3, Census Tract 205, Polk County, Oregon",790,532,258,41,053,020500,3
"Block Group 1, Census Tract 64.03, Multnomah County, Oregon",389,336,53,41,051,006403,1
"Block Group 2, Census Tract 104.10, Multnomah County, Oregon",784,308,476,41,051,010410,2
"Block Group 3, Census Tract 307.01, Yamhill County, Oregon",599,528,71,41,071,030701,3
"Block Group 2, Census Tract 301.02, Yamhill County, Oregon",1399,1201,198,41,071,030102,2
"Block Group 1, Census Tract 306.02, Yamhill County, Oregon",1149,1029,120,41,071,030602,1
"Block Group 3, Census Tract 306.01, Yamhill County, Oregon",202,156,46,41,071,030601,3
"Block Group 2, Census Tract 301.01, Yamhill County, Oregon",1085,978,107,41,071,030101,2
"Block Group 3, Census Tract 303.01, Yamhill County, Oregon",394,343,51,41,071,030301,3
"Block Group 0, Census Tract 9900, Clatsop County, Oregon",0,0,0,41,007,990000,0
"Block Group 4, Census Tract 310.04, Washington County, Oregon",1266,830,436,41,067,031004,4
"Block Group 4, Census Tract 3611, Josephine County, Oregon",1096,564,532,41,033,361100,4
"Block Group 3, Census Tract 202, Clackamas County, Oregon",375,244,131,41,005,020200,3
"Block Group 1, Census Tract 205.03, Clackamas County, Oregon",522,444,78,41,005,020503,1
"Block Group 1, Census Tract 9503, Umatilla County, Oregon",362,354,8,41,059,950300,1
"Block Group 2, Census Tract 9504, Umatilla County, Oregon",187,31,156,41,059,950400,2
"Block Group 4, Census Tract 9504, Umatilla County, Oregon",211,193,18,41,059,950400,4
"Block Group 5, Census Tract 9506, Umatilla County, Oregon",624,430,194,41,059,950600,5
"Block Group 2, Census Tract 2, Multnomah County, Oregon",1050,556,494,41,051,000200,2
"Block Group 1, Census Tract 2, Multnomah County, Oregon",459,157,302,41,051,000200,1
"Block Group 1, Census Tract 4.02, Multnomah County, Oregon",559,350,209,41,051,000402,1
"Block Group 1, Census Tract 15, Multnomah County, Oregon",647,541,106,41,051,001500,1
"Block Group 1, Census Tract 100.02, Multnomah County, Oregon",1010,648,362,41,051,010002,1
"Block Group 1, Census Tract 77, Multnomah County, Oregon",435,357,78,41,051,007700,1
"Block Group 1, Census Tract 81, Multnomah County, Oregon",1069,280,789,41,051,008100,1
"Block Group 2, Census Tract 87, Multnomah County, Oregon",697,441,256,41,051,008700,2
"Block Group 1, Census Tract 9707, Malheur County, Oregon",628,407,221,41,045,970700,1
"Block Group 4, Census Tract 1, Multnomah County, Oregon",497,258,239,41,051,000100,4
"Block Group 4, Census Tract 6.02, Multnomah County, Oregon",421,220,201,41,051,000602,4
"Block Group 1, Census Tract 8.01, Multnomah County, Oregon",549,334,215,41,051,000801,1
"Block Group 3, Census Tract 7.01, Multnomah County, Oregon",588,323,265,41,051,000701,3
"Block Group 4, Census Tract 7.01, Multnomah County, Oregon",422,226,196,41,051,000701,4
"Block Group 1, Census Tract 16.02, Multnomah County, Oregon",411,228,183,41,051,001602,1
"Block Group 1, Census Tract 72.02, Multnomah County, Oregon",1267,819,448,41,051,007202,1
"Block Group 2, Census Tract 79, Multnomah County, Oregon",1115,738,377,41,051,007900,2
"Block Group 3, Census Tract 82.02, Multnomah County, Oregon",649,340,309,41,051,008202,3
"Block Group 1, Census Tract 93.02, Multnomah County, Oregon",1116,575,541,41,051,009302,1
"Block Group 1, Census Tract 97.01, Multnomah County, Oregon",1001,286,715,41,051,009701,1
"Block Group 1, Census Tract 103.03, Multnomah County, Oregon",1074,546,528,41,051,010303,1
"Block Group 3, Census Tract 1, Multnomah County, Oregon",285,104,181,41,051,000100,3
"Block Group 1, Census Tract 326.06, Washington County, Oregon",436,234,202,41,067,032606,1
"Block Group 2, Census Tract 28, Lane County, Oregon",584,370,214,41,039,002800,2
"Block Group 3, Census Tract 28, Lane County, Oregon",542,384,158,41,039,002800,3
"Block Group 3, Census Tract 213, Clackamas County, Oregon",359,287,72,41,005,021300,3
"Block Group 4, Census Tract 204.01, Clackamas County, Oregon",721,674,47,41,005,020401,4
"Block Group 1, Census Tract 204.01, Clackamas County, Oregon",521,489,32,41,005,020401,1
"Block Group 1, Census Tract 3614, Josephine County, Oregon",455,418,37,41,033,361400,1
"Block Group 3, Census Tract 3607.01, Josephine County, Oregon",374,143,231,41,033,360701,3
"Block Group 2, Census Tract 3603, Josephine County, Oregon",527,401,126,41,033,360300,2
"Block Group 1, Census Tract 3604, Josephine County, Oregon",733,733,0,41,033,360400,1
"Block Group 4, Census Tract 3612, Josephine County, Oregon",445,336,109,41,033,361200,4
"Block Group 2, Census Tract 99.06, Multnomah County, Oregon",478,446,32,41,051,009906,2
"Block Group 1, Census Tract 106, Multnomah County, Oregon",561,0,561,41,051,010600,1
"Block Group 2, Census Tract 23.03, Multnomah County, Oregon",1249,88,1161,41,051,002303,2
"Block Group 3, Census Tract 22.03, Multnomah County, Oregon",460,165,295,41,051,002203,3
"Block Group 4, Census Tract 307.02, Yamhill County, Oregon",861,432,429,41,071,030702,4
"Block Group 3, Census Tract 308.02, Yamhill County, Oregon",448,305,143,41,071,030802,3
"Block Group 2, Census Tract 18.02, Multnomah County, Oregon",652,338,314,41,051,001802,2
"Block Group 1, Census Tract 21, Multnomah County, Oregon",732,0,732,41,051,002100,1
"Block Group 2, Census Tract 24.02, Multnomah County, Oregon",732,220,512,41,051,002402,2
"Block Group 3, Census Tract 29.03, Multnomah County, Oregon",322,198,124,41,051,002903,3
"Block Group 3, Census Tract 33.01, Multnomah County, Oregon",475,224,251,41,051,003301,3
"Block Group 1, Census Tract 37.02, Multnomah County, Oregon",286,230,56,41,051,003702,1
"Block Group 3, Census Tract 38.01, Multnomah County, Oregon",609,281,328,41,051,003801,3
"Block Group 1, Census Tract 317.04, Washington County, Oregon",536,489,47,41,067,031704,1
"Block Group 4, Census Tract 101, Multnomah County, Oregon",662,406,256,41,051,010100,4
"Block Group 2, Census Tract 103.06, Multnomah County, Oregon",717,492,225,41,051,010306,2
"Block Group 2, Census Tract 104.09, Multnomah County, Oregon",761,640,121,41,051,010409,2
"Block Group 2, Census Tract 3612, Josephine County, Oregon",803,523,280,41,033,361200,2
"Block Group 2, Census Tract 3609, Josephine County, Oregon",288,261,27,41,033,360900,2
"Block Group 5, Census Tract 3606, Josephine County, Oregon",386,95,291,41,033,360600,5
"Block Group 4, Census Tract 3606, Josephine County, Oregon",476,218,258,41,033,360600,4
"Block Group 4, Census Tract 27, Marion County, Oregon",359,359,0,41,047,002700,4
"Block Group 0, Census Tract 9900, Douglas County, Oregon",0,0,0,41,019,990000,0
"Block Group 1, Census Tract 315.13, Washington County, Oregon",1248,1123,125,41,067,031513,1
"Block Group 2, Census Tract 301.01, Washington County, Oregon",474,379,95,41,067,030101,2
"Block Group 2, Census Tract 301.02, Washington County, Oregon",1449,1290,159,41,067,030102,2
"Block Group 3, Census Tract 316.15, Washington County, Oregon",497,464,33,41,067,031615,3
"Block Group 2, Census Tract 324.08, Washington County, Oregon",1813,1267,546,41,067,032408,2
"Block Group 1, Census Tract 326.10, Washington County, Oregon",661,512,149,41,067,032610,1
"Block Group 1, Census Tract 318.14, Washington County, Oregon",355,325,30,41,067,031814,1
"Block Group 1, Census Tract 323, Washington County, Oregon",2040,1590,450,41,067,032300,1
"Block Group 2, Census Tract 326.06, Washington County, Oregon",614,69,545,41,067,032606,2
"Block Group 2, Census Tract 9501, Clatsop County, Oregon",512,365,147,41,007,950100,2
"Block Group 2, Census Tract 9507, Clatsop County, Oregon",393,279,114,41,007,950700,2
"Block Group 2, Census Tract 9504, Clatsop County, Oregon",668,590,78,41,007,950400,2
"Block Group 4, Census Tract 9511, Clatsop County, Oregon",350,237,113,41,007,951100,4
"Block Group 3, Census Tract 2, Coos County, Oregon",239,169,70,41,011,000200,3
"Block Group 2, Census Tract 331.02, Washington County, Oregon",518,219,299,41,067,033102,2
"Block Group 1, Census Tract 319.11, Washington County, Oregon",1203,541,662,41,067,031911,1
"Block Group 2, Census Tract 45.02, Lane County, Oregon",434,94,340,41,039,004502,2
"Block Group 3, Census Tract 48, Multnomah County, Oregon",587,127,460,41,051,004800,3
"Block Group 4, Census Tract 52, Multnomah County, Oregon",1092,251,841,41,051,005200,4
"Block Group 4, Census Tract 56, Multnomah County, Oregon",744,171,573,41,051,005600,4
"Block Group 1, Census Tract 16.01, Multnomah County, Oregon",428,223,205,41,051,001601,1
"Block Group 5, Census Tract 16.01, Multnomah County, Oregon",480,333,147,41,051,001601,5
"Block Group 4, Census Tract 6.01, Multnomah County, Oregon",605,348,257,41,051,000601,4
"Block Group 3, Census Tract 6.01, Multnomah County, Oregon",311,198,113,41,051,000601,3
"Block Group 3, Census Tract 9.01, Multnomah County, Oregon",489,186,303,41,051,000901,3
"Block Group 3, Census Tract 24.03, Lane County, Oregon",430,374,56,41,039,002403,3
"Block Group 1, Census Tract 9506.01, Lincoln County, Oregon",193,150,43,41,041,950601,1
"Block Group 4, Census Tract 5.04, Coos County, Oregon",328,113,215,41,011,000504,4
"Block Group 0, Census Tract 9901.01, Coos County, Oregon",0,0,0,41,011,990101,0
"Block Group 1, Census Tract 33.01, Lane County, Oregon",524,270,254,41,039,003301,1
"Block Group 2, Census Tract 229.07, Clackamas County, Oregon",602,207,395,41,005,022907,2
"Block Group 1, Census Tract 9506.02, Lincoln County, Oregon",458,323,135,41,041,950602,1
"Block Group 2, Census Tract 9503.04, Lincoln County, Oregon",361,123,238,41,041,950304,2
"Block Group 1, Census Tract 229.06, Clackamas County, Oregon",737,486,251,41,005,022906,1
"Block Group 1, Census Tract 319.09, Washington County, Oregon",1047,842,205,41,067,031909,1
"Block Group 1, Census Tract 319.12, Washington County, Oregon",795,628,167,41,067,031912,1
"Block Group 1, Census Tract 324.09, Washington County, Oregon",653,174,479,41,067,032409,1
"Block Group 2, Census Tract 333.02, Washington County, Oregon",1299,1196,103,41,067,033302,2
"Block Group 5, Census Tract 324.06, Washington County, Oregon",578,433,145,41,067,032406,5
"Block Group 3, Census Tract 88, Multnomah County, Oregon",531,375,156,41,051,008800,3
"Block Group 1, Census Tract 92.01, Multnomah County, Oregon",782,377,405,41,051,009201,1
